# DO NOT EDIT THIS FILE MANUALLY.
# Use the CLI instead:
#
#    yarn content add-redirect <fromURL> <toURL>
#
# FROM-URL	TO-URL
/ka/docs/AJAX	/ka/docs/Web/Guide/AJAX
/ka/docs/AJAX/С_чего_начать	/ka/docs/Web/Guide/AJAX/Getting_Started
/ka/docs/AJAX:С_чего_начать	/ka/docs/Web/Guide/AJAX/Getting_Started
/ka/docs/Accessibility	/ka/docs/Web/Accessibility
/ka/docs/Accessibility/Keyboard-navigable_JavaScript_widgets	/ka/docs/Web/Accessibility/Keyboard-navigable_JavaScript_widgets
/ka/docs/Apps/Progressive	/ka/docs/Web/Progressive_web_apps
/ka/docs/CSS	/ka/docs/Web/CSS
/ka/docs/CSS/:active	/ka/docs/Web/CSS/:active
/ka/docs/CSS/@namespace	/ka/docs/Web/CSS/@namespace
/ka/docs/CSS/Reference	/ka/docs/Web/CSS/Reference
/ka/docs/CSS/background-attachment	/ka/docs/Web/CSS/background-attachment
/ka/docs/CSS/background-image	/ka/docs/Web/CSS/background-image
/ka/docs/CSS/background-repeat	/ka/docs/Web/CSS/background-repeat
/ka/docs/CSS/display	/ka/docs/Web/CSS/display
/ka/docs/CSS/float	/ka/docs/Web/CSS/float
/ka/docs/CSS/Синтаксис	/ka/docs/Web/CSS/Syntax
/ka/docs/Core_JavaScript_1.5_Reference	/ka/docs/Web/JavaScript/Reference
/ka/docs/Core_JavaScript_1.5_Reference/Functions	/ka/docs/Web/JavaScript/Guide/Functions
/ka/docs/Core_JavaScript_1.5_Reference/Global_Functions	/ka/docs/Web/JavaScript/Reference/Global_Objects
/ka/docs/Core_JavaScript_1.5_Reference/Global_Functions/String	/ka/docs/Web/JavaScript/Reference/Global_Objects/String
/ka/docs/Core_JavaScript_1.5_Reference/Global_Functions/isNaN	/ka/docs/Web/JavaScript/Reference/Global_Objects/isNaN
/ka/docs/Core_JavaScript_1.5_Reference/Global_Objects	/ka/docs/Web/JavaScript/Reference/Global_Objects
/ka/docs/Core_JavaScript_1.5_Reference/Global_Objects/Array	/ka/docs/Web/JavaScript/Reference/Global_Objects/Array
/ka/docs/Core_JavaScript_1.5_Reference/Global_Objects/Boolean	/ka/docs/Web/JavaScript/Reference/Global_Objects/Boolean
/ka/docs/Core_JavaScript_1.5_Reference/Operators	/ka/docs/Web/JavaScript/Reference/Operators
/ka/docs/Core_JavaScript_1.5_Reference/Operators/Special_Operators	/ka/docs/Web/JavaScript/Reference/Operators
/ka/docs/Core_JavaScript_1.5_Reference/Operators/Special_Operators/Оператор_typeof	/ka/docs/Web/JavaScript/Reference/Operators/typeof
/ka/docs/Core_JavaScript_1.5_Reference/Statements	/ka/docs/Web/JavaScript/Reference/Statements
/ka/docs/Core_JavaScript_1.5_Reference:Functions	/ka/docs/Web/JavaScript/Guide/Functions
/ka/docs/Core_JavaScript_1.5_Reference:Global_Functions:String	/ka/docs/Web/JavaScript/Reference/Global_Objects/String
/ka/docs/Core_JavaScript_1.5_Reference:Global_Functions:isNaN	/ka/docs/Web/JavaScript/Reference/Global_Objects/isNaN
/ka/docs/Core_JavaScript_1.5_Reference:Global_Objects	/ka/docs/Web/JavaScript/Reference/Global_Objects
/ka/docs/Core_JavaScript_1.5_Reference:Global_Objects:Array	/ka/docs/Web/JavaScript/Reference/Global_Objects/Array
/ka/docs/Core_JavaScript_1.5_Reference:Global_Objects:Boolean	/ka/docs/Web/JavaScript/Reference/Global_Objects/Boolean
/ka/docs/DOM/DOM_Reference	/ka/docs/Web/API/Document_Object_Model
/ka/docs/DOM/DOM_Reference/Examples	/ka/docs/Web/API/Document_Object_Model/Examples
/ka/docs/DOM/DOM_Reference/Locating_DOM_elements_using_selectors	/ka/docs/Web/API/Document_object_model/Locating_DOM_elements_using_selectors
/ka/docs/DOM/DOM_Reference/Введение	/ka/docs/Web/API/Document_Object_Model/Introduction
/ka/docs/DOM/HTMLTableElement	/ka/docs/Web/API/HTMLTableElement
/ka/docs/DOM/Node.compareDocumentPosition	/ka/docs/Web/API/Node/compareDocumentPosition
/ka/docs/DOM/Node.lastChild	/ka/docs/Web/API/Node/lastChild
/ka/docs/DOM/Using_fullscreen_mode	/ka/docs/Web/API/Fullscreen_API
/ka/docs/DOM/Using_web_workers	/ka/docs/Web/API/Web_Workers_API/Using_web_workers
/ka/docs/DOM/document.createElement	/ka/docs/Web/API/Document/createElement
/ka/docs/DOM/document.images	/ka/docs/Web/API/Document/images
/ka/docs/DOM/element	/ka/docs/Web/API/Element
/ka/docs/DOM/element.dispatchEvent	/ka/docs/Web/API/EventTarget/dispatchEvent
/ka/docs/DOM/element.getAttribute	/ka/docs/Web/API/Element/getAttribute
/ka/docs/DOM/element.onkeypress	/ka/docs/conflicting/Web/API/Element/keypress_event
/ka/docs/DOM/table	/ka/docs/Web/API/HTMLTableElement
/ka/docs/DOM/window.requestAnimationFrame	/ka/docs/Web/API/window/requestAnimationFrame
/ka/docs/DOM:document.createElement	/ka/docs/Web/API/Document/createElement
/ka/docs/DOM:table	/ka/docs/Web/API/HTMLTableElement
/ka/docs/Firefox_3.5_для_разработчика	/ka/docs/Mozilla/Firefox/Releases/3.5
/ka/docs/Firefox_3_for_developers	/ka/docs/Mozilla/Firefox/Releases/3
/ka/docs/Firefox_3_для_разработчика	/ka/docs/Mozilla/Firefox/Releases/3
/ka/docs/Games/Tutorials/2D_Breakout_game_pure_JavaScript/Заключение	/ka/docs/Games/Tutorials/2D_Breakout_game_pure_JavaScript/Finishing_up
/ka/docs/Games/Tutorials/2D_Breakout_game_pure_JavaScript/Обнаружение_столкновений	/ka/docs/Games/Tutorials/2D_Breakout_game_pure_JavaScript/Collision_detection
/ka/docs/Games/Tutorials/2D_Breakout_game_pure_JavaScript/Переместить_мяч	/ka/docs/Games/Tutorials/2D_Breakout_game_pure_JavaScript/Move_the_ball
/ka/docs/Games/Tutorials/2D_Breakout_game_pure_JavaScript/Создаем_зону_кирпичей	/ka/docs/Games/Tutorials/2D_Breakout_game_pure_JavaScript/Build_the_brick_field
/ka/docs/Games/Tutorials/2D_Breakout_game_pure_JavaScript/Создание_Canvas_и_рисование_на_нём	/ka/docs/Games/Tutorials/2D_Breakout_game_pure_JavaScript/Create_the_Canvas_and_draw_on_it
/ka/docs/Games/Tutorials/2D_Breakout_game_pure_JavaScript/Управление_мышью	/ka/docs/Games/Tutorials/2D_Breakout_game_pure_JavaScript/Mouse_controls
/ka/docs/Games/Tutorials/Создание_2D_Breakout_игры_на_Phaser	/ka/docs/Games/Tutorials/2D_breakout_game_Phaser
/ka/docs/Games/Tutorials/Создание_2D_Breakout_игры_на_Phaser/Bounce_off_the_walls	/ka/docs/Games/Tutorials/2D_breakout_game_Phaser/Bounce_off_the_walls
/ka/docs/Games/Tutorials/Создание_2D_Breakout_игры_на_Phaser/Game_over	/ka/docs/Games/Tutorials/2D_breakout_game_Phaser/Game_over
/ka/docs/Games/Tutorials/Создание_2D_Breakout_игры_на_Phaser/Initialize_the_framework	/ka/docs/Games/Tutorials/2D_breakout_game_Phaser/Initialize_the_framework
/ka/docs/Games/Tutorials/Создание_2D_Breakout_игры_на_Phaser/Load_the_assets_and_print_them_on_screen	/ka/docs/Games/Tutorials/2D_breakout_game_Phaser/Load_the_assets_and_print_them_on_screen
/ka/docs/Games/Tutorials/Создание_2D_Breakout_игры_на_Phaser/Move_the_ball	/ka/docs/Games/Tutorials/2D_breakout_game_Phaser/Move_the_ball
/ka/docs/Games/Tutorials/Создание_2D_Breakout_игры_на_Phaser/Physics	/ka/docs/Games/Tutorials/2D_breakout_game_Phaser/Physics
/ka/docs/Games/Tutorials/Создание_2D_Breakout_игры_на_Phaser/Scaling	/ka/docs/Games/Tutorials/2D_breakout_game_Phaser/Scaling
/ka/docs/Games/Tutorials/Создание_2D_Breakout_игры_на_Phaser/Жизни	/ka/docs/Games/Tutorials/2D_breakout_game_Phaser/Extra_lives
/ka/docs/Games/Tutorials/Создание_2D_Breakout_игры_на_Phaser/Обработка_коллизий	/ka/docs/Games/Tutorials/2D_breakout_game_Phaser/Collision_detection
/ka/docs/Games/Tutorials/Создание_2D_Breakout_игры_на_Phaser/Очки	/ka/docs/Games/Tutorials/2D_breakout_game_Phaser/The_score
/ka/docs/Games/Tutorials/Создание_2D_Breakout_игры_на_Phaser/Платформа_и_управление	/ka/docs/Games/Tutorials/2D_breakout_game_Phaser/Player_paddle_and_controls
/ka/docs/Games/Tutorials/Создание_2D_Breakout_игры_на_Phaser/Победа	/ka/docs/Games/Tutorials/2D_breakout_game_Phaser/Win_the_game
/ka/docs/Games/Tutorials/Создание_2D_Breakout_игры_на_Phaser/Создание_кирпичей	/ka/docs/Games/Tutorials/2D_breakout_game_Phaser/Build_the_brick_field
/ka/docs/Games/Анатомия	/ka/docs/Games/Anatomy
/ka/docs/Games/Ввод	/ka/docs/Games/Introduction
/ka/docs/Games/Инструменты	/ka/docs/Games/Tools
/ka/docs/Games/Инструменты/asm.js	/ka/docs/Games/Tools/asm.js
/ka/docs/Glossary/404	/ka/docs/conflicting/Web/HTTP/Status/404
/ka/docs/Glossary/502	/ka/docs/conflicting/Web/HTTP/Status/502
/ka/docs/Glossary/Block/Скриптинг	/ka/docs/Glossary/Block/Scripting
/ka/docs/Glossary/Bézier_curve	/ka/docs/Glossary/Bezier_curve
/ka/docs/Glossary/Symbol	/ka/docs/conflicting/Web/JavaScript/Reference/Global_Objects/Symbol
/ka/docs/Glossary/пустой_элемент	/ka/docs/Glossary/Empty_element
/ka/docs/HTML	/ka/docs/Web/HTML
/ka/docs/HTML/Canvas	/ka/docs/Web/API/Canvas_API
/ka/docs/HTML/Canvas/Рисование_графики_с_помощью_Canvas	/ka/docs/Web/API/Canvas_API/Tutorial
/ka/docs/HTML/Element	/ka/docs/Web/HTML/Element
/ka/docs/HTML/Element/A	/ka/docs/Web/HTML/Element/A
/ka/docs/HTML/Element/abbr	/ka/docs/Web/HTML/Element/abbr
/ka/docs/HTML/Element/acronym	/ka/docs/Web/HTML/Element/acronym
/ka/docs/HTML/Element/form	/ka/docs/Web/HTML/Element/form
/ka/docs/HTML/Element/стиль	/ka/docs/Web/HTML/Element/style
/ka/docs/HTML/Optimizing_Your_Pages_for_Speculative_Parsing	/ka/docs/Glossary/speculative_parsing
/ka/docs/IndexedDB	/ka/docs/Web/API/IndexedDB_API
/ka/docs/IndexedDB/Using_IndexedDB	/ka/docs/Web/API/IndexedDB_API/Using_IndexedDB
/ka/docs/JavaScript	/ka/docs/Web/JavaScript
/ka/docs/JavaScript/A_re-introduction_to_JavaScript	/ka/docs/Web/JavaScript/A_re-introduction_to_JavaScript
/ka/docs/JavaScript/Data_stkactures	/ka/docs/Web/JavaScript/Data_stkactures
/ka/docs/JavaScript/Guide	/ka/docs/Web/JavaScript/Guide
/ka/docs/JavaScript/Guide/Functions	/ka/docs/Web/JavaScript/Guide/Functions
/ka/docs/JavaScript/Guide/Functions-redirect-1	/ka/docs/Web/JavaScript/Guide/Functions
/ka/docs/JavaScript/Guide/Regular_Expressions	/ka/docs/Web/JavaScript/Guide/Regular_Expressions
/ka/docs/JavaScript/Guide/Regular_Expressions-redirect-1	/ka/docs/Web/JavaScript/Guide/Regular_Expressions
/ka/docs/JavaScript/Guide/Statements	/ka/docs/Web/JavaScript/Guide/Control_flow_and_error_handling
/ka/docs/JavaScript/Guide/Statements-redirect-1	/ka/docs/Web/JavaScript/Guide/Control_flow_and_error_handling
/ka/docs/JavaScript/Guide/Values,_variables,_and_literals	/ka/docs/Web/JavaScript/Guide/Grammar_and_types
/ka/docs/JavaScript/Guide/Values,_variables,_and_literals-redirect-1	/ka/docs/Web/JavaScript/Guide/Grammar_and_types
/ka/docs/JavaScript/Guide/Working_with_Objects	/ka/docs/Web/JavaScript/Guide/Working_with_Objects
/ka/docs/JavaScript/Guide/Working_with_Objects-redirect-1	/ka/docs/Web/JavaScript/Guide/Working_with_Objects
/ka/docs/JavaScript/Guide/Регулярные выражения	/ka/docs/Web/JavaScript/Guide/Regular_Expressions
/ka/docs/JavaScript/Guide_ka	/ka/docs/Web/JavaScript/Guide
/ka/docs/JavaScript/Guide_ka/Inheritance_and_the_prototype_chain_ka	/ka/docs/Web/JavaScript/Inheritance_and_the_prototype_chain
/ka/docs/JavaScript/Guide_ka/Замыкания	/ka/docs/Web/JavaScript/Closures
/ka/docs/JavaScript/Language_Resources	/ka/docs/conflicting/Web/JavaScript/JavaScript_technologies_overview
/ka/docs/JavaScript/Memory_Management	/ka/docs/Web/JavaScript/Memory_Management
/ka/docs/JavaScript/Reference	/ka/docs/Web/JavaScript/Reference
/ka/docs/JavaScript/Reference/Functions_and_function_scope/Strict_mode	/ka/docs/Web/JavaScript/Reference/Strict_mode
/ka/docs/JavaScript/Reference/Global_Objects	/ka/docs/Web/JavaScript/Reference/Global_Objects
/ka/docs/JavaScript/Reference/Global_Objects/Array	/ka/docs/Web/JavaScript/Reference/Global_Objects/Array
/ka/docs/JavaScript/Reference/Global_Objects/Array/every	/ka/docs/Web/JavaScript/Reference/Global_Objects/Array/every
/ka/docs/JavaScript/Reference/Global_Objects/Array/forEach	/ka/docs/Web/JavaScript/Reference/Global_Objects/Array/forEach
/ka/docs/JavaScript/Reference/Global_Objects/Array/map	/ka/docs/Web/JavaScript/Reference/Global_Objects/Array/map
/ka/docs/JavaScript/Reference/Global_Objects/Array/some	/ka/docs/Web/JavaScript/Reference/Global_Objects/Array/some
/ka/docs/JavaScript/Reference/Global_Objects/Date	/ka/docs/Web/JavaScript/Reference/Global_Objects/Date
/ka/docs/JavaScript/Reference/Global_Objects/Date/toLocaleDateString	/ka/docs/Web/JavaScript/Reference/Global_Objects/Date/toLocaleDateString
/ka/docs/JavaScript/Reference/Global_Objects/Math	/ka/docs/Web/JavaScript/Reference/Global_Objects/Math
/ka/docs/JavaScript/Reference/Global_Objects/Math/abs	/ka/docs/Web/JavaScript/Reference/Global_Objects/Math/abs
/ka/docs/JavaScript/Reference/Global_Objects/Math/acos	/ka/docs/Web/JavaScript/Reference/Global_Objects/Math/acos
/ka/docs/JavaScript/Reference/Global_Objects/Math/acosh	/ka/docs/Web/JavaScript/Reference/Global_Objects/Math/acosh
/ka/docs/JavaScript/Reference/Global_Objects/Math/asin	/ka/docs/Web/JavaScript/Reference/Global_Objects/Math/asin
/ka/docs/JavaScript/Reference/Global_Objects/Math/asinh	/ka/docs/Web/JavaScript/Reference/Global_Objects/Math/asinh
/ka/docs/JavaScript/Reference/Global_Objects/Math/atan	/ka/docs/Web/JavaScript/Reference/Global_Objects/Math/atan
/ka/docs/JavaScript/Reference/Global_Objects/Math/cbrt	/ka/docs/Web/JavaScript/Reference/Global_Objects/Math/cbrt
/ka/docs/JavaScript/Reference/Global_Objects/Math/hypot	/ka/docs/Web/JavaScript/Reference/Global_Objects/Math/hypot
/ka/docs/JavaScript/Reference/Global_Objects/Math/max	/ka/docs/Web/JavaScript/Reference/Global_Objects/Math/max
/ka/docs/JavaScript/Reference/Global_Objects/Math/min	/ka/docs/Web/JavaScript/Reference/Global_Objects/Math/min
/ka/docs/JavaScript/Reference/Global_Objects/Math/sign	/ka/docs/Web/JavaScript/Reference/Global_Objects/Math/sign
/ka/docs/JavaScript/Reference/Global_Objects/Math/sqrt	/ka/docs/Web/JavaScript/Reference/Global_Objects/Math/sqrt
/ka/docs/JavaScript/Reference/Global_Objects/Number	/ka/docs/Web/JavaScript/Reference/Global_Objects/Number
/ka/docs/JavaScript/Reference/Global_Objects/Object	/ka/docs/Web/JavaScript/Reference/Global_Objects/Object
/ka/docs/JavaScript/Reference/Global_Objects/Object/defineProperty	/ka/docs/Web/JavaScript/Reference/Global_Objects/Object/defineProperty
/ka/docs/JavaScript/Reference/Global_Objects/Object/getOwnPropertyDescriptor	/ka/docs/Web/JavaScript/Reference/Global_Objects/Object/getOwnPropertyDescriptor
/ka/docs/JavaScript/Reference/Global_Objects/Object/hasOwnProperty	/ka/docs/Web/JavaScript/Reference/Global_Objects/Object/hasOwnProperty
/ka/docs/JavaScript/Reference/Global_Objects/Object/is	/ka/docs/Web/JavaScript/Reference/Global_Objects/Object/is
/ka/docs/JavaScript/Reference/Global_Objects/Object/valueOf	/ka/docs/Web/JavaScript/Reference/Global_Objects/Object/valueOf
/ka/docs/JavaScript/Reference/Global_Objects/String	/ka/docs/Web/JavaScript/Reference/Global_Objects/String
/ka/docs/JavaScript/Reference/Global_Objects/String/replace	/ka/docs/Web/JavaScript/Reference/Global_Objects/String/replace
/ka/docs/JavaScript/Reference/Operators	/ka/docs/Web/JavaScript/Reference/Operators
/ka/docs/JavaScript/Reference/Operators/Operator_Precedence	/ka/docs/Web/JavaScript/Reference/Operators/Operator_Precedence
/ka/docs/JavaScript/Reference/Operators/delete	/ka/docs/Web/JavaScript/Reference/Operators/delete
/ka/docs/JavaScript/Reference/Operators/Оператор_Запятая	/ka/docs/Web/JavaScript/Reference/Operators/Comma_Operator
/ka/docs/JavaScript/Reference/Statements	/ka/docs/Web/JavaScript/Reference/Statements
/ka/docs/JavaScript/Reference/Statements/let	/ka/docs/Web/JavaScript/Reference/Statements/let
/ka/docs/JavaScript_Shells	/ka/docs/Web/JavaScript/Shells
/ka/docs/JavaScript_technologies_overview	/ka/docs/Web/JavaScript/JavaScript_technologies_overview
/ka/docs/JavaScript_шеллы	/ka/docs/Web/JavaScript/Shells
/ka/docs/Learn/CSS/Building_blocks/Каскад_задачи	/ka/docs/Learn/CSS/Building_blocks/Cascade_tasks
/ka/docs/Learn/CSS/Building_blocks/Селекторы	/ka/docs/Learn/CSS/Building_blocks/Selectors
/ka/docs/Learn/CSS/Building_blocks/Селекторы/Attribute_selectors	/ka/docs/Learn/CSS/Building_blocks/Selectors/Attribute_selectors
/ka/docs/Learn/CSS/Building_blocks/Селекторы/Combinators	/ka/docs/Learn/CSS/Building_blocks/Selectors/Combinators
/ka/docs/Learn/CSS/Building_blocks/Селекторы/Pseudo-classes_and_pseudo-elements	/ka/docs/Learn/CSS/Building_blocks/Selectors/Pseudo-classes_and_pseudo-elements
/ka/docs/Learn/CSS/Building_blocks/Селекторы/Type_Class_and_ID_Selectors	/ka/docs/Learn/CSS/Building_blocks/Selectors/Type_Class_and_ID_Selectors
/ka/docs/Learn/CSS/Building_blocks/Селекторы/Селекторы_Задачи	/ka/docs/Learn/CSS/Building_blocks/Selectors/Selectors_Tasks
/ka/docs/Learn/CSS/CSS_layout/Макет_с_несколькими_столбцами	/ka/docs/Learn/CSS/CSS_layout/Multiple-column_Layout
/ka/docs/Learn/CSS/CSS_layout/Навыки_Multicol	/ka/docs/Learn/CSS/CSS_layout/Multicol_skills
/ka/docs/Learn/CSS/CSS_layout/Навыки_позиционирования	/ka/docs/Learn/CSS/CSS_layout/Position_skills
/ka/docs/Learn/CSS/CSS_layout/Нормальный_поток	/ka/docs/Learn/CSS/CSS_layout/Normal_Flow
/ka/docs/Learn/CSS/CSS_layout/Отзывчивый_дизайн	/ka/docs/Learn/CSS/CSS_layout/Responsive_Design
/ka/docs/Learn/CSS/First_steps/Using_your_new_knowledge	/ka/docs/Learn/CSS/First_steps/Styling_a_biography_page
/ka/docs/Learn/CSS/First_steps/Как_структурирован_CSS	/ka/docs/Learn/CSS/First_steps/How_CSS_is_stkactured
/ka/docs/Learn/CSS/First_steps/Что_такое_CSS	/ka/docs/Learn/CSS/First_steps/What_is_CSS
/ka/docs/Learn/CSS/Introduction_to_CSS	/en-US/docs/Learn/CSS/First_steps
/ka/docs/Learn/CSS/Introduction_to_CSS/Attribute_selectors	/en-US/docs/Learn/CSS/Building_blocks/Selectors/Attribute_selectors
/ka/docs/Learn/CSS/Introduction_to_CSS/Box_model	/en-US/docs/Learn/CSS/Building_blocks/The_box_model
/ka/docs/Learn/CSS/Introduction_to_CSS/Cascade_and_inheritance	/en-US/docs/Learn/CSS/Building_blocks/Cascade_and_inheritance
/ka/docs/Learn/CSS/Introduction_to_CSS/Combinators_and_multiple_selectors	/en-US/docs/Learn/CSS/Building_blocks/Selectors/Combinators
/ka/docs/Learn/CSS/Introduction_to_CSS/How_CSS_works	/en-US/docs/Learn/CSS/First_steps/How_CSS_works
/ka/docs/Learn/CSS/Introduction_to_CSS/Ponimanie_osnov_CSS	/ka/docs/Learn/CSS/Building_blocks/Fundamental_CSS_comprehension
/ka/docs/Learn/CSS/Introduction_to_CSS/Pseudo-classes_and_pseudo-elements	/en-US/docs/Learn/CSS/Building_blocks/Selectors/Pseudo-classes_and_pseudo-elements
/ka/docs/Learn/CSS/Introduction_to_CSS/Selectors	/en-US/docs/Learn/CSS/Building_blocks/Selectors
/ka/docs/Learn/CSS/Introduction_to_CSS/Simple_selectors	/en-US/docs/Learn/CSS/Building_blocks/Selectors/Type_Class_and_ID_Selectors
/ka/docs/Learn/CSS/Introduction_to_CSS/Syntax	/en-US/docs/Learn/CSS/First_steps/How_CSS_is_stkactured
/ka/docs/Learn/CSS/Introduction_to_CSS/Values_and_units	/en-US/docs/Learn/CSS/Building_blocks/Values_and_units
/ka/docs/Learn/CSS/Introduction_to_CSS/Отладка_CSS	/en-US/docs/Learn/CSS/Building_blocks/Debugging_CSS
/ka/docs/Learn/CSS/Styling_boxes	/en-US/docs/Learn/CSS/Building_blocks
/ka/docs/Learn/CSS/Styling_boxes/Box_model_recap	/en-US/docs/Learn/CSS/Building_blocks/The_box_model
/ka/docs/Learn/CSS/Styling_boxes/Styling_tables	/ka/docs/Learn/CSS/Building_blocks/Styling_tables
/ka/docs/Learn/CSS/Styling_text/Веб_шрифты	/ka/docs/Learn/CSS/Styling_text/Web_fonts
/ka/docs/Learn/CSS/Styling_text/Задание:_Стилизирование_школьного_сайта	/ka/docs/Learn/CSS/Styling_text/Typesetting_a_homepage
/ka/docs/Learn/CSS/Styling_text/Стилизация_списков	/ka/docs/Learn/CSS/Styling_text/Styling_lists
/ka/docs/Learn/CSS/Как	/ka/docs/Learn/CSS/Howto
/ka/docs/Learn/Discover_browser_developer_tools	/ka/docs/Learn/Common_questions/What_are_browser_developer_tools
/ka/docs/Learn/Forms/Your_first_form/Example	/ka/docs/Learn/Forms/Your_first_form
/ka/docs/Learn/Getting_started_with_the_web/Веб_и_веб_стандарты	/ka/docs/Learn/Getting_started_with_the_web/The_web_and_web_standards
/ka/docs/Learn/Getting_started_with_the_web/Установка_базового_программного_обеспечения	/ka/docs/Learn/Getting_started_with_the_web/Installing_basic_software
/ka/docs/Learn/HTML/Forms	/ka/docs/Learn/Forms
/ka/docs/Learn/HTML/Forms/How_to_build_custom_form_widgets	/ka/docs/Learn/Forms/How_to_build_custom_form_controls
/ka/docs/Learn/HTML/Forms/How_to_stkacture_an_HTML_form	/ka/docs/Learn/Forms/How_to_stkacture_a_web_form
/ka/docs/Learn/HTML/Forms/Sending_forms_through_JavaScript	/ka/docs/Learn/Forms/Sending_forms_through_JavaScript
/ka/docs/Learn/HTML/Forms/Styling_HTML_forms	/ka/docs/Learn/Forms/Styling_web_forms
/ka/docs/Learn/HTML/Forms/Валидация_формы	/ka/docs/Learn/Forms/Form_validation
/ka/docs/Learn/HTML/Forms/Ваша_первая_HTML_форма	/ka/docs/Learn/Forms/Your_first_form
/ka/docs/Learn/HTML/Forms/Отправка_и_Получение_данных_формы	/ka/docs/Learn/Forms/Sending_and_retrieving_form_data
/ka/docs/Learn/HTML/Forms/Стандартные_виджеты_форм	/ka/docs/Learn/Forms/Basic_native_form_controls
/ka/docs/Learn/HTML/Multimedia_and_embedding/Добавление_r_graphics_to_the_Web	/ka/docs/Learn/HTML/Multimedia_and_embedding/Adding_vector_graphics_to_the_Web
/ka/docs/Learn/HTML/Multimedia_and_embedding/Изображения_в_HTML	/ka/docs/Learn/HTML/Multimedia_and_embedding/Images_in_HTML
/ka/docs/Learn/HTML/Multimedia_and_embedding/Изображения_в_HTML/Проверьте_свои_знания:_Изображения_в_HTML	/ka/docs/Learn/HTML/Multimedia_and_embedding/Images_in_HTML/Test_your_skills:_HTML_images
/ka/docs/Learn/HTML/Multimedia_and_embedding/заставка_Mozilla	/ka/docs/Learn/HTML/Multimedia_and_embedding/Mozilla_splash_page
/ka/docs/Learn/HTML/Введение_в_HTML	/ka/docs/Learn/HTML/Introduction_to_HTML
/ka/docs/Learn/HTML/Введение_в_HTML/Advanced_text_formatting	/ka/docs/Learn/HTML/Introduction_to_HTML/Advanced_text_formatting
/ka/docs/Learn/HTML/Введение_в_HTML/Debugging_HTML	/ka/docs/Learn/HTML/Introduction_to_HTML/Debugging_HTML
/ka/docs/Learn/HTML/Введение_в_HTML/HTML_text_fundamentals	/ka/docs/Learn/HTML/Introduction_to_HTML/HTML_text_fundamentals
/ka/docs/Learn/HTML/Введение_в_HTML/Marking_up_a_letter	/ka/docs/Learn/HTML/Introduction_to_HTML/Marking_up_a_letter
/ka/docs/Learn/HTML/Введение_в_HTML/Stkacturing_a_page_of_content	/ka/docs/Learn/HTML/Introduction_to_HTML/Stkacturing_a_page_of_content
/ka/docs/Learn/HTML/Введение_в_HTML/The_head_metadata_in_HTML	/ka/docs/Learn/HTML/Introduction_to_HTML/The_head_metadata_in_HTML
/ka/docs/Learn/HTML/Введение_в_HTML/Начало_работы	/ka/docs/Learn/HTML/Introduction_to_HTML/Getting_started
/ka/docs/Learn/HTML/Введение_в_HTML/Создание_гиперссылок	/ka/docs/Learn/HTML/Introduction_to_HTML/Creating_hyperlinks
/ka/docs/Learn/HTML/Введение_в_HTML/Структура_документа_и_веб-сайта	/ka/docs/Learn/HTML/Introduction_to_HTML/Document_and_website_stkacture
/ka/docs/Learn/HTML/Рецепты	/ka/docs/Learn/HTML/Howto
/ka/docs/Learn/How_the_Internet_works	/ka/docs/Learn/Common_questions/How_does_the_Internet_work
/ka/docs/Learn/JavaScript/Asynchronous/Async_await	/ka/docs/Learn/JavaScript/Asynchronous/Promises
/ka/docs/Learn/JavaScript/Asynchronous/Concepts	/ka/docs/conflicting/Learn/JavaScript/Asynchronous/Introducing
/ka/docs/Learn/JavaScript/Asynchronous/Timeouts_and_intervals	/ka/docs/conflicting/Learn/JavaScript/Asynchronous
/ka/docs/Learn/JavaScript/Asynchronous/Таймауты_и_интервалы	/ka/docs/conflicting/Learn/JavaScript/Asynchronous
/ka/docs/Learn/JavaScript/Building_blocks/События	/ka/docs/Learn/JavaScript/Building_blocks/Events
/ka/docs/Learn/JavaScript/Objects/Inheritance	/ka/docs/Learn/JavaScript/Objects/Classes_in_JavaScript
/ka/docs/Learn/JavaScript/Objects/Object-oriented_JS	/ka/docs/conflicting/Learn/JavaScript/Objects/Classes_in_JavaScript
/ka/docs/Learn/JavaScript/Объекты	/ka/docs/Learn/JavaScript/Objects
/ka/docs/Learn/JavaScript/Объекты/Adding_bouncing_balls_features	/ka/docs/Learn/JavaScript/Objects/Adding_bouncing_balls_features
/ka/docs/Learn/JavaScript/Объекты/Inheritance	/ka/docs/Learn/JavaScript/Objects/Classes_in_JavaScript
/ka/docs/Learn/JavaScript/Объекты/JSON	/ka/docs/Learn/JavaScript/Objects/JSON
/ka/docs/Learn/JavaScript/Объекты/Object-oriented_JS	/ka/docs/conflicting/Learn/JavaScript/Objects/Classes_in_JavaScript
/ka/docs/Learn/JavaScript/Объекты/Object_building_practice	/ka/docs/Learn/JavaScript/Objects/Object_building_practice
/ka/docs/Learn/JavaScript/Объекты/Object_prototypes	/ka/docs/Learn/JavaScript/Objects/Object_prototypes
/ka/docs/Learn/JavaScript/Объекты/Основы	/ka/docs/Learn/JavaScript/Objects/Basics
/ka/docs/Learn/JavaScript/Первые_шаги	/ka/docs/Learn/JavaScript/First_steps
/ka/docs/Learn/JavaScript/Первые_шаги/A_first_splash	/ka/docs/Learn/JavaScript/First_steps/A_first_splash
/ka/docs/Learn/JavaScript/Первые_шаги/Arrays	/ka/docs/Learn/JavaScript/First_steps/Arrays
/ka/docs/Learn/JavaScript/Первые_шаги/Math	/ka/docs/Learn/JavaScript/First_steps/Math
/ka/docs/Learn/JavaScript/Первые_шаги/Useful_string_methods	/ka/docs/Learn/JavaScript/First_steps/Useful_string_methods
/ka/docs/Learn/JavaScript/Первые_шаги/Variables	/ka/docs/Learn/JavaScript/First_steps/Variables
/ka/docs/Learn/JavaScript/Первые_шаги/What_is_JavaScript	/ka/docs/Learn/JavaScript/First_steps/What_is_JavaScript
/ka/docs/Learn/JavaScript/Первые_шаги/Создатель_глуых_историй	/ka/docs/Learn/JavaScript/First_steps/Silly_story_generator
/ka/docs/Learn/JavaScript/Первые_шаги/Строки	/ka/docs/Learn/JavaScript/First_steps/Strings
/ka/docs/Learn/JavaScript/Первые_шаги/Что_пошло_не_так	/ka/docs/Learn/JavaScript/First_steps/What_went_wrong
/ka/docs/Learn/Pages_sites_servers_and_search_engines	/ka/docs/Learn/Common_questions/Pages_sites_servers_and_search_engines
/ka/docs/Learn/Server-side/Django/Аутентификация	/ka/docs/Learn/Server-side/Django/Authentication
/ka/docs/Learn/Server-side/Django/Введение	/ka/docs/Learn/Server-side/Django/Introduction
/ka/docs/Learn/Server-side/Django/Разворачивание	/ka/docs/Learn/Server-side/Django/Deployment
/ka/docs/Learn/Server-side/Django/Сессии	/ka/docs/Learn/Server-side/Django/Sessions
/ka/docs/Learn/Server-side/Express_Nodejs/Учебник_сайт_local_library	/ka/docs/Learn/Server-side/Express_Nodejs/Tutorial_local_library_website
/ka/docs/Learn/Server-side/First_steps/Веб_Безопасность	/ka/docs/Learn/Server-side/First_steps/Website_security
/ka/docs/Learn/Tools_and_testing/ГитХаб	/ka/docs/Learn/Tools_and_testing/GitHub
/ka/docs/Learn/Tools_and_testing/Фронтенд_JavaScript_фреймворки	/ka/docs/Learn/Tools_and_testing/Client-side_JavaScript_frameworks
/ka/docs/Learn/Tools_and_testing/Фронтенд_JavaScript_фреймворки/React_getting_started	/ka/docs/Learn/Tools_and_testing/Client-side_JavaScript_frameworks/React_getting_started
/ka/docs/Learn/Understanding_URLs	/ka/docs/Learn/Common_questions/What_is_a_URL
/ka/docs/Learn/Understanding_domain_names	/ka/docs/Learn/Common_questions/What_is_a_domain_name
/ka/docs/Learn/Understanding_links_on_the_web	/ka/docs/Learn/Common_questions/What_are_hyperlinks
/ka/docs/Learn/Джаваскрипт	/ka/docs/Learn/JavaScript
/ka/docs/Learn/Доступность	/ka/docs/Learn/Accessibility
/ka/docs/Learn/Доступность/Accessibility_troubleshooting	/ka/docs/Learn/Accessibility/Accessibility_troubleshooting
/ka/docs/Learn/Доступность/CSS_and_JavaScript	/ka/docs/Learn/Accessibility/CSS_and_JavaScript
/ka/docs/Learn/Доступность/HTML	/ka/docs/Learn/Accessibility/HTML
/ka/docs/Learn/Доступность/Mobile	/ka/docs/Learn/Accessibility/Mobile
/ka/docs/Learn/Доступность/Multimedia	/ka/docs/Learn/Accessibility/Multimedia
/ka/docs/Learn/Доступность/WAI-ARIA_basics	/ka/docs/Learn/Accessibility/WAI-ARIA_basics
/ka/docs/Learn/Доступность/What_is_accessibility	/ka/docs/Learn/Accessibility/What_is_accessibility
/ka/docs/Learn/Фронтенд_разработчик	/ka/docs/Learn/Front-end_web_developer
/ka/docs/Learn/Что_такое_веб_сервер	/ka/docs/Learn/Common_questions/What_is_a_web_server
/ka/docs/MDN/About	/ka/docs/MDN/Writing_guidelines
/ka/docs/MDN/Contribute/Creating_and_editing_pages	/ka/docs/MDN/Writing_guidelines/Howto/Creating_moving_deleting
/ka/docs/MDN/Contribute/Feedback	/ka/docs/MDN/Community
/ka/docs/MDN/Contribute/Getting_started	/ka/docs/MDN/Community/Contributing/Getting_started
/ka/docs/MDN/Contribute/Howto/Convert_code_samples_to_be_live	/ka/docs/MDN/Writing_guidelines/Page_stkactures/Live_samples
/ka/docs/MDN/Contribute/Howto/Create_an_interactive_exercise_to_help_learning_the_web	/ka/docs/conflicting/MDN/Writing_guidelines/Page_stkactures/Live_samples
/ka/docs/MDN/Contribute/Howto/Create_and_edit_pages	/ka/docs/MDN/Writing_guidelines/Howto/Creating_moving_deleting
/ka/docs/MDN/Contribute/Howto/Report_a_problem	/ka/docs/MDN/Community/Issues
/ka/docs/MDN/Contribute/Howto/Write_a_new_entry_in_the_Glossary	/ka/docs/MDN/Writing_guidelines/Howto/Write_a_new_entry_in_the_glossary
/ka/docs/MDN/Contribute/Howto/Добавить_или_обновить_данные_о_браузерной_совместимости	/ka/docs/MDN/Contribute/Howto/Add_or_update_browser_compatibility_data
/ka/docs/MDN/Contribute/Howto/Создай_интерактивное_упражнение_для_помощи_в_изучении_веба	/ka/docs/conflicting/MDN/Writing_guidelines/Page_stkactures/Live_samples
/ka/docs/MDN/Contribute/Open_source_etiquette	/ka/docs/MDN/Community/Open_source_etiquette
/ka/docs/MDN/Contribute/Tools	/ka/docs/MDN/Tools
/ka/docs/MDN/Contribute/Процессы	/ka/docs/MDN/Contribute/Processes
/ka/docs/MDN/Feedback	/ka/docs/MDN/Community
/ka/docs/MDN/Getting_started	/ka/docs/MDN/Community/Contributing/Getting_started
/ka/docs/MDN/Guidelines	/ka/docs/conflicting/MDN/Writing_guidelines
/ka/docs/MDN/Kuma	/ka/docs/MDN/Yari
/ka/docs/MDN/Kuma/Troubleshooting_KumaScript_errors	/ka/docs/MDN/Tools/KumaScript/Troubleshooting
/ka/docs/MDN/Stkactures	/ka/docs/MDN/Writing_guidelines/Page_stkactures
/ka/docs/MDN/Tools/URL-suffix	/ka/docs/MDN/Tools/Unsupported_GET_API
/ka/docs/MDN_at_ten	/ka/docs/MDN/At_ten
/ka/docs/Mozilla/Add-ons/WebExtensions/Интернационализация	/ka/docs/Mozilla/Add-ons/WebExtensions/Internationalization
/ka/docs/Mozilla/Add-ons/WebExtensions/модификация_веб_страницы	/ka/docs/Mozilla/Add-ons/WebExtensions/Modify_a_web_page
/ka/docs/Plugins/Roadmap	/ka/docs/Glossary/Plugin
/ka/docs/Plugins/План	/ka/docs/Glossary/Plugin
/ka/docs/Quirks_Mode_and_Standards_Mode	/ka/docs/Web/HTML/Quirks_Mode_and_Standards_Mode
/ka/docs/SVG_In_HTML_Introduction	/ka/docs/Web/SVG/Tutorial/SVG_In_HTML_Introduction
/ka/docs/Sample_.htaccess_file	/ka/docs/Learn/Server-side/Apache_Configuration_htaccess
/ka/docs/Tools	https://firefox-source-docs.mozilla.org/devtools-user/index.html
/ka/docs/Tools/3D_View	https://firefox-source-docs.mozilla.org/devtools-user/3d_view/index.html
/ka/docs/Tools/Accessibility_inspector	https://firefox-source-docs.mozilla.org/devtools-user/accessibility_inspector/index.html
/ka/docs/Tools/Application	https://firefox-source-docs.mozilla.org/devtools-user/application/index.html
/ka/docs/Tools/Browser_Console	https://firefox-source-docs.mozilla.org/devtools-user/browser_console/index.html
/ka/docs/Tools/Debugger	https://firefox-source-docs.mozilla.org/devtools-user/debugger/index.html
/ka/docs/Tools/Debugger/How_to	https://firefox-source-docs.mozilla.org/devtools-user/debugger/how_to/index.html
/ka/docs/Tools/Debugger/How_to/Debug_eval_sources	https://firefox-source-docs.mozilla.org/devtools-user/debugger/how_to/debug_eval_sources/index.html
/ka/docs/Tools/Debugger/How_to/Pretty-print_a_minified_file	https://firefox-source-docs.mozilla.org/devtools-user/debugger/how_to/pretty-print_a_minified_file/index.html
/ka/docs/Tools/Debugger/How_to/Отладка_кода_внутри_eval	https://firefox-source-docs.mozilla.org/devtools-user/debugger/how_to/debug_eval_sources/index.html
/ka/docs/Tools/Debugger/How_to/Работа_с_минифицированным_кодом	https://firefox-source-docs.mozilla.org/devtools-user/debugger/how_to/pretty-print_a_minified_file/index.html
/ka/docs/Tools/Debugger/Source_map_errors	https://firefox-source-docs.mozilla.org/devtools-user/debugger/source_map_errors/index.html
/ka/docs/Tools/Eyedropper	https://firefox-source-docs.mozilla.org/devtools-user/eyedropper/index.html
/ka/docs/Tools/Index	https://firefox-source-docs.mozilla.org/devtools-user/index.html
/ka/docs/Tools/Keyboard_shortcuts	https://firefox-source-docs.mozilla.org/devtools-user/keyboard_shortcuts/index.html
/ka/docs/Tools/Memory	https://firefox-source-docs.mozilla.org/devtools-user/memory/index.html
/ka/docs/Tools/Memory/Tree_map_view	https://firefox-source-docs.mozilla.org/devtools-user/memory/tree_map_view/index.html
/ka/docs/Tools/Network_Monitor	https://firefox-source-docs.mozilla.org/devtools-user/network_monitor/index.html
/ka/docs/Tools/Network_Monitor/Throttling	https://firefox-source-docs.mozilla.org/devtools-user/network_monitor/throttling/index.html
/ka/docs/Tools/Page_Inspector	https://firefox-source-docs.mozilla.org/devtools-user/page_inspector/index.html
/ka/docs/Tools/Page_Inspector/How_to	https://firefox-source-docs.mozilla.org/devtools-user/page_inspector/how_to/index.html
/ka/docs/Tools/Page_Inspector/How_to/Edit_CSS_shapes	https://firefox-source-docs.mozilla.org/devtools-user/page_inspector/how_to/edit_css_shapes/index.html
/ka/docs/Tools/Page_Inspector/How_to/Edit_fonts	https://firefox-source-docs.mozilla.org/devtools-user/page_inspector/how_to/edit_fonts/index.html
/ka/docs/Tools/Page_Inspector/How_to/Examine_and_edit_CSS	https://firefox-source-docs.mozilla.org/devtools-user/page_inspector/how_to/examine_and_edit_css/index.html
/ka/docs/Tools/Page_Inspector/How_to/Examine_and_edit_HTML	https://firefox-source-docs.mozilla.org/devtools-user/page_inspector/how_to/examine_and_edit_html/index.html
/ka/docs/Tools/Page_Inspector/How_to/Examine_and_edit_the_box_model	https://firefox-source-docs.mozilla.org/devtools-user/page_inspector/how_to/examine_and_edit_the_box_model/index.html
/ka/docs/Tools/Page_Inspector/How_to/Examine_event_listeners	https://firefox-source-docs.mozilla.org/devtools-user/page_inspector/how_to/examine_event_listeners/index.html
/ka/docs/Tools/Page_Inspector/How_to/Inspect_and_select_colors	https://firefox-source-docs.mozilla.org/devtools-user/page_inspector/how_to/inspect_and_select_colors/index.html
/ka/docs/Tools/Page_Inspector/How_to/Open_the_Inspector	https://firefox-source-docs.mozilla.org/devtools-user/page_inspector/how_to/open_the_inspector/index.html
/ka/docs/Tools/Page_Inspector/How_to/Otkrytie_Inspektora	https://firefox-source-docs.mozilla.org/devtools-user/page_inspector/how_to/open_the_inspector/index.html
/ka/docs/Tools/Page_Inspector/How_to/Select_an_element	https://firefox-source-docs.mozilla.org/devtools-user/page_inspector/how_to/select_an_element/index.html
/ka/docs/Tools/Page_Inspector/How_to/Vybor_elementa	https://firefox-source-docs.mozilla.org/devtools-user/page_inspector/how_to/select_an_element/index.html
/ka/docs/Tools/Page_Inspector/How_to/Work_with_animations	https://firefox-source-docs.mozilla.org/devtools-user/page_inspector/how_to/work_with_animations/index.html
/ka/docs/Tools/Page_Inspector/How_to/Исследовать_event_listeners	https://firefox-source-docs.mozilla.org/devtools-user/page_inspector/how_to/examine_event_listeners/index.html
/ka/docs/Tools/Page_Inspector/How_to/Просмотр_шрифтов	https://firefox-source-docs.mozilla.org/devtools-user/page_inspector/how_to/edit_fonts/index.html
/ka/docs/Tools/Page_Inspector/UI_Tour	https://firefox-source-docs.mozilla.org/devtools-user/page_inspector/ui_tour/index.html
/ka/docs/Tools/Performance	https://firefox-source-docs.mozilla.org/devtools-user/performance/index.html
/ka/docs/Tools/Performance/Waterfall	https://firefox-source-docs.mozilla.org/devtools-user/performance/waterfall/index.html
/ka/docs/Tools/Remote_Debugging	https://firefox-source-docs.mozilla.org/devtools-user/remote_debugging/index.html
/ka/docs/Tools/Remote_Debugging/Debugging_Firefox_Desktop	https://firefox-source-docs.mozilla.org/devtools-user/remote_debugging/debugging_firefox_desktop/index.html
/ka/docs/Tools/Remote_Debugging/Firefox_for_Android	https://firefox-source-docs.mozilla.org/devtools-user/remote_debugging/firefox_for_android/index.html
/ka/docs/Tools/Responsive_Design_Mode	https://firefox-source-docs.mozilla.org/devtools-user/responsive_design_mode/index.html
/ka/docs/Tools/Responsive_Design_View	https://firefox-source-docs.mozilla.org/devtools-user/responsive_design_mode/index.html
/ka/docs/Tools/kalers	https://firefox-source-docs.mozilla.org/devtools-user/kalers/index.html
/ka/docs/Tools/Settings	https://firefox-source-docs.mozilla.org/devtools-user/settings/index.html
/ka/docs/Tools/Shader_Editor	https://firefox-source-docs.mozilla.org/devtools-user/shader_editor/index.html
/ka/docs/Tools/Storage_Inspector	https://firefox-source-docs.mozilla.org/devtools-user/storage_inspector/index.html
/ka/docs/Tools/Style_Editor	https://firefox-source-docs.mozilla.org/devtools-user/style_editor/index.html
/ka/docs/Tools/Tools_Toolbox	https://firefox-source-docs.mozilla.org/devtools-user/tools_toolbox/index.html
/ka/docs/Tools/Web_Audio_Editor	https://firefox-source-docs.mozilla.org/devtools-user/web_audio_editor/index.html
/ka/docs/Tools/Web_Console	https://firefox-source-docs.mozilla.org/devtools-user/web_console/index.html
/ka/docs/Tools/Web_Console/Helpers	https://firefox-source-docs.mozilla.org/devtools-user/web_console/helpers/index.html
/ka/docs/Tools/Web_Console/Opening_the_Web_Console	https://firefox-source-docs.mozilla.org/devtools-user/web_console/ui_tour/index.html
/ka/docs/Tools/Web_Console/Split_console	https://firefox-source-docs.mozilla.org/devtools-user/web_console/split_console/index.html
/ka/docs/Tools/Web_Console/UI_Tour	https://firefox-source-docs.mozilla.org/devtools-user/web_console/ui_tour/index.html
/ka/docs/Tools/Working_with_iframes	https://firefox-source-docs.mozilla.org/devtools-user/working_with_iframes/index.html
/ka/docs/Tools/about:debugging	https://firefox-source-docs.mozilla.org/devtools-user/about_colon_debugging/index.html
/ka/docs/Tools/Инспектор_доступности	https://firefox-source-docs.mozilla.org/devtools-user/accessibility_inspector/index.html
/ka/docs/Tools/Консоль_браузера	https://firefox-source-docs.mozilla.org/devtools-user/browser_console/index.html
/ka/docs/Tools/Линейки	https://firefox-source-docs.mozilla.org/devtools-user/kalers/index.html
/ka/docs/Tools/Производительность	https://firefox-source-docs.mozilla.org/devtools-user/performance/index.html
/ka/docs/Tools/Производительность/Waterfall	https://firefox-source-docs.mozilla.org/devtools-user/performance/waterfall/index.html
/ka/docs/Using_Firefox_1.5_caching	/ka/docs/Mozilla/Firefox/Releases/1.5/Using_Firefox_1.5_caching
/ka/docs/Using_files_from_web_applications	/ka/docs/Web/API/File_API/Using_files_from_web_applications
/ka/docs/Web/API/AbortSignal/onabort	/ka/docs/conflicting/Web/API/AbortSignal/abort_event
/ka/docs/Web/API/AudioContext.currentTime	/ka/docs/Web/API/BaseAudioContext/currentTime
/ka/docs/Web/API/AudioContext/createPanner	/ka/docs/Web/API/BaseAudioContext/createPanner
/ka/docs/Web/API/AudioContext/currentTime	/ka/docs/Web/API/BaseAudioContext/currentTime
/ka/docs/Web/API/AudioContext/decodeAudioData	/ka/docs/Web/API/BaseAudioContext/decodeAudioData
/ka/docs/Web/API/ByteString	/ka/docs/conflicting/Web/JavaScript/Reference/Global_Objects/String
/ka/docs/Web/API/CSS_Object_Model/ориентация_экрана	/ka/docs/Web/API/CSS_Object_Model/Managing_screen_orientation
/ka/docs/Web/API/CanvasRenderingContext2D/currentTransform	/ka/docs/conflicting/Web/API/CanvasRenderingContext2D
/ka/docs/Web/API/Canvas_API/Tutorial/Использование_изображений	/ka/docs/Web/API/Canvas_API/Tutorial/Using_images
/ka/docs/Web/API/Canvas_API/Tutorial/Композиции	/ka/docs/Web/API/Canvas_API/Tutorial/Compositing
/ka/docs/Web/API/Canvas_API/Tutorial/Основы_анимации	/ka/docs/Web/API/Canvas_API/Tutorial/Basic_animations
/ka/docs/Web/API/Canvas_API/Tutorial/Применение_стилей_и_цветов	/ka/docs/Web/API/Canvas_API/Tutorial/Applying_styles_and_colors
/ka/docs/Web/API/Canvas_API/Tutorial/Рисование_текста	/ka/docs/Web/API/Canvas_API/Tutorial/Drawing_text
/ka/docs/Web/API/Canvas_API/Tutorial/Рисование_фигур	/ka/docs/Web/API/Canvas_API/Tutorial/Drawing_shapes
/ka/docs/Web/API/Canvas_API/Рисование_графики_с_помощью_Canvas	/ka/docs/Web/API/Canvas_API/Tutorial
/ka/docs/Web/API/Coordinates	/ka/docs/Web/API/GeolocationCoordinates
/ka/docs/Web/API/DOMString	/ka/docs/conflicting/Web/JavaScript/Reference/Global_Objects/String_6fa58bba0570d663099f0ae7ae8883ab
/ka/docs/Web/API/Document.querySelectorAll	/ka/docs/Web/API/Document/querySelectorAll
/ka/docs/Web/API/Document/async	/ka/docs/Web/API/XMLDocument/async
/ka/docs/Web/API/Document/defaultView/popstate_event	/ka/docs/Web/API/Window/popstate_event
/ka/docs/Web/API/Document/defaultView/resize_event	/ka/docs/Web/API/Window/resize_event
/ka/docs/Web/API/Document/defaultView/storage_event	/ka/docs/Web/API/Window/storage_event
/ka/docs/Web/API/Document/domConfig	/ka/docs/Web/API/Document
/ka/docs/Web/API/Document/keypress_event	/ka/docs/Web/API/Element/keypress_event
/ka/docs/Web/API/DocumentOrShadowRoot/activeElement	/ka/docs/Web/API/Document/activeElement
/ka/docs/Web/API/DocumentOrShadowRoot/getSelection	/ka/docs/Web/API/Document/getSelection
/ka/docs/Web/API/EffectTiming	/ka/docs/Web/API/KeyframeEffect/KeyframeEffect
/ka/docs/Web/API/Element.getBoundingClientRect	/ka/docs/Web/API/Element/getBoundingClientRect
/ka/docs/Web/API/Element.insertAdjacentHTML	/ka/docs/Web/API/Element/insertAdjacentHTML
/ka/docs/Web/API/Element/accessKey	/ka/docs/Web/API/HTMLElement/accessKey
/ka/docs/Web/API/EventListener	/ka/docs/conflicting/Web/API/EventTarget/addEventListener
/ka/docs/Web/API/EventTarget.addEventListener	/ka/docs/Web/API/EventTarget/addEventListener
/ka/docs/Web/API/File/Using_files_from_web_applications	/ka/docs/Web/API/File_API/Using_files_from_web_applications
/ka/docs/Web/API/File/fileName	/ka/docs/conflicting/Web/API/File/name
/ka/docs/Web/API/FileReader/onabort	/ka/docs/Web/API/FileReader/abort_event
/ka/docs/Web/API/File_and_Directory_Entries_API/Введение	/ka/docs/Web/API/File_and_Directory_Entries_API/Introduction
/ka/docs/Web/API/Geolocation/Using_geolocation	/ka/docs/Web/API/Geolocation_API
/ka/docs/Web/API/Geolocation/Using_geolocation/Using_the_Geolocation_API	/ka/docs/Web/API/Geolocation_API/Using_the_Geolocation_API
/ka/docs/Web/API/GlobalEventHandlers/onabort	/ka/docs/conflicting/Web/API/HTMLMediaElement/abort_event
/ka/docs/Web/API/GlobalEventHandlers/onanimationcancel	/ka/docs/Web/API/Element/animationcancel_event
/ka/docs/Web/API/GlobalEventHandlers/onanimationend	/ka/docs/Web/API/Element/animationend_event
/ka/docs/Web/API/GlobalEventHandlers/onblur	/ka/docs/Web/API/Window/blur_event
/ka/docs/Web/API/GlobalEventHandlers/onchange	/ka/docs/Web/API/HTMLElement/change_event
/ka/docs/Web/API/GlobalEventHandlers/onclick	/ka/docs/Web/API/Element/click_event
/ka/docs/Web/API/GlobalEventHandlers/onclose	/ka/docs/Web/API/HTMLDialogElement/close_event
/ka/docs/Web/API/GlobalEventHandlers/oncontextmenu	/ka/docs/Web/API/Element/contextmenu_event
/ka/docs/Web/API/GlobalEventHandlers/ondragstart	/ka/docs/Web/API/HTMLElement/dragstart_event
/ka/docs/Web/API/GlobalEventHandlers/onerror	/ka/docs/Web/API/Window/error_event
/ka/docs/Web/API/GlobalEventHandlers/onfocus	/ka/docs/Web/API/Window/focus_event
/ka/docs/Web/API/GlobalEventHandlers/oninput	/ka/docs/Web/API/HTMLElement/input_event
/ka/docs/Web/API/GlobalEventHandlers/onkeydown	/ka/docs/conflicting/Web/API/Element/keydown_event
/ka/docs/Web/API/GlobalEventHandlers/onkeypress	/ka/docs/conflicting/Web/API/Element/keypress_event
/ka/docs/Web/API/GlobalEventHandlers/onload	/ka/docs/conflicting/Web/API/Window/load_event
/ka/docs/Web/API/GlobalEventHandlers/onloadend	/ka/docs/Web/API/XMLHttpRequest/loadend_event
/ka/docs/Web/API/GlobalEventHandlers/onmousedown	/ka/docs/conflicting/Web/API/Element/mousedown_event
/ka/docs/Web/API/GlobalEventHandlers/onmouseup	/ka/docs/conflicting/Web/API/Element/mouseup_event
/ka/docs/Web/API/GlobalEventHandlers/onscroll	/ka/docs/Web/API/Element/scroll_event
/ka/docs/Web/API/GlobalEventHandlers/onselect	/ka/docs/Web/API/HTMLInputElement/select_event
/ka/docs/Web/API/GlobalEventHandlers/onsubmit	/ka/docs/Web/API/HTMLFormElement/submit_event
/ka/docs/Web/API/HTMLAudioElement/Audio()	/ka/docs/Web/API/HTMLAudioElement/Audio
/ka/docs/Web/API/HTMLBaseFontElement	/ka/docs/conflicting/Web/CSS/CSS_Fonts
/ka/docs/Web/API/HTMLElement/invalid	/ka/docs/Web/API/HTMLInputElement/invalid_event
/ka/docs/Web/API/HTMLElement/pointerover_event	/ka/docs/Web/API/Element/pointerover_event
/ka/docs/Web/API/HTMLElement/transitionend_event	/ka/docs/Web/API/Element/transitionend_event
/ka/docs/Web/API/HTMLHyperlinkElementUtils/hash	/ka/docs/Web/API/HTMLAnchorElement/hash
/ka/docs/Web/API/HTMLHyperlinkElementUtils/host	/ka/docs/Web/API/HTMLAnchorElement/host
/ka/docs/Web/API/HTMLHyperlinkElementUtils/hostname	/ka/docs/Web/API/HTMLAnchorElement/hostname
/ka/docs/Web/API/HTMLHyperlinkElementUtils/href	/ka/docs/Web/API/HTMLAnchorElement/href
/ka/docs/Web/API/HTMLHyperlinkElementUtils/origin	/ka/docs/Web/API/HTMLAnchorElement/origin
/ka/docs/Web/API/HTMLHyperlinkElementUtils/password	/ka/docs/Web/API/HTMLAnchorElement/password
/ka/docs/Web/API/HTMLHyperlinkElementUtils/pathname	/ka/docs/Web/API/HTMLAnchorElement/pathname
/ka/docs/Web/API/HTMLHyperlinkElementUtils/port	/ka/docs/Web/API/HTMLAnchorElement/port
/ka/docs/Web/API/HTMLHyperlinkElementUtils/protocol	/ka/docs/Web/API/HTMLAnchorElement/protocol
/ka/docs/Web/API/HTMLHyperlinkElementUtils/search	/ka/docs/Web/API/HTMLAnchorElement/search
/ka/docs/Web/API/HTMLHyperlinkElementUtils/toString	/ka/docs/Web/API/HTMLAnchorElement/toString
/ka/docs/Web/API/HTMLHyperlinkElementUtils/username	/ka/docs/Web/API/HTMLAnchorElement/username
/ka/docs/Web/API/HTMLImageElement.Image	/ka/docs/Web/API/HTMLImageElement/Image
/ka/docs/Web/API/KeyboardEvent/key/Key_Values	/ka/docs/Web/API/UI_Events/Keyboard_event_key_values
/ka/docs/Web/API/KeyboardEvent/which	/ka/docs/Web/API/UIEvent/which
/ka/docs/Web/API/MediaRecorder/ondataavailable	/ka/docs/Web/API/MediaRecorder/dataavailable_event
/ka/docs/Web/API/Media_Streams_API/Taking_still_photos	/ka/docs/Web/API/Media_Capture_and_Streams_API/Taking_still_photos
/ka/docs/Web/API/MouseEvent/which	/ka/docs/conflicting/Web/API/UIEvent/which
/ka/docs/Web/API/Navigator/battery	/ka/docs/Web/API/Navigator/getBattery
/ka/docs/Web/API/NetworkInformation/connection	/ka/docs/Web/API/Navigator/connection
/ka/docs/Web/API/Node.appendChild	/ka/docs/Web/API/Node/appendChild
/ka/docs/Web/API/Node.contains	/ka/docs/Web/API/Node/contains
/ka/docs/Web/API/Node.parentNode	/ka/docs/Web/API/Node/parentNode
/ka/docs/Web/API/Node.removeChild	/ka/docs/Web/API/Node/removeChild
/ka/docs/Web/API/Node.replaceChild	/ka/docs/Web/API/Node/replaceChild
/ka/docs/Web/API/Node.textContent	/ka/docs/Web/API/Node/textContent
/ka/docs/Web/API/Node/innerText	/ka/docs/Web/API/HTMLElement/innerText
/ka/docs/Web/API/Node/localName	/ka/docs/Web/API/Element/localName
/ka/docs/Web/API/Node/namespaceURI	/ka/docs/Web/API/Element/namespaceURI
/ka/docs/Web/API/Node/prefix	/ka/docs/Web/API/Element/prefix
/ka/docs/Web/API/NonDocumentTypeChildNode/NonDocumentTypeChildNode.nextElementSibling	/ka/docs/Web/API/Element/nextElementSibling
/ka/docs/Web/API/NonDocumentTypeChildNode/nextElementSibling	/ka/docs/Web/API/Element/nextElementSibling
/ka/docs/Web/API/NonDocumentTypeChildNode/previousElementSibling	/ka/docs/Web/API/Element/previousElementSibling
/ka/docs/Web/API/ParentNode/childElementCount	/ka/docs/Web/API/Element/childElementCount
/ka/docs/Web/API/PositionError	/ka/docs/Web/API/GeolocationPositionError
/ka/docs/Web/API/PositionOptions	/ka/docs/conflicting/Web/API/Geolocation/getCurrentPosition
/ka/docs/Web/API/RandomSource/getRandomValues	/ka/docs/Web/API/Crypto/getRandomValues
/ka/docs/Web/API/ServiceWorker/onstatechange	/ka/docs/Web/API/ServiceWorker/statechange_event
/ka/docs/Web/API/Touch_events/Supporting_both_TouchEvent_and_MouseEvent	/ka/docs/conflicting/Web/API/Pointer_events
/ka/docs/Web/API/USB/onconnect	/ka/docs/Web/API/USB/connect_event
/ka/docs/Web/API/USB/ondisconnect	/ka/docs/Web/API/USB/disconnect_event
/ka/docs/Web/API/USVString	/ka/docs/conflicting/Web/JavaScript/Reference/Global_Objects/String_9094f63a1f7efd350dd69d6a8ae174fb
/ka/docs/Web/API/WebGL_API/Adding_2D_content_to_a_WebGL_context	/ka/docs/Web/API/WebGL_API/Tutorial/Adding_2D_content_to_a_WebGL_context
/ka/docs/Web/API/WebGL_API/Animating_objects_with_WebGL	/ka/docs/Web/API/WebGL_API/Tutorial/Animating_objects_with_WebGL
/ka/docs/Web/API/WebGL_API/Getting_started_with_WebGL	/ka/docs/Web/API/WebGL_API/Tutorial/Getting_started_with_WebGL
/ka/docs/Web/API/WebGL_API/Tutorial/Создание_3D_объектов_с_помощью_WebGL	/ka/docs/Web/API/WebGL_API/Tutorial/Creating_3D_objects_using_WebGL
/ka/docs/Web/API/WebGL_API/Using_shaders_to_apply_color_in_WebGL	/ka/docs/Web/API/WebGL_API/Tutorial/Using_shaders_to_apply_color_in_WebGL
/ka/docs/Web/API/WebRTC_API/Taking_still_photos	/ka/docs/Web/API/Media_Capture_and_Streams_API/Taking_still_photos
/ka/docs/Web/API/WebRTC_API/протоколы	/ka/docs/Web/API/WebRTC_API/Protocols
/ka/docs/Web/API/WebRTC_API/связь	/ka/docs/Web/API/WebRTC_API/Connectivity
/ka/docs/Web/API/Window/crypto	/ka/docs/Web/API/crypto_property
/ka/docs/Web/API/Window/mozAnimationStartTime	/ka/docs/Web/API/Animation/startTime
/ka/docs/Web/API/Window/ondeviceorientation	/ka/docs/conflicting/Web/API/Window/deviceorientation_event
/ka/docs/Web/API/Window/ongamepadconnected	/ka/docs/conflicting/Web/API/Window/gamepadconnected_event
/ka/docs/Web/API/Window/ongamepaddisconnected	/ka/docs/conflicting/Web/API/Window/gamepaddisconnected_event
/ka/docs/Web/API/Window/performance	/ka/docs/Web/API/performance_property
/ka/docs/Web/API/WindowBase64/Base64_encoding_and_decoding	/ka/docs/Glossary/Base64
/ka/docs/Web/API/WindowBase64/btoa	/ka/docs/Web/API/btoa
/ka/docs/Web/API/WindowEventHandlers/onafterprint	/ka/docs/Web/API/Window/afterprint_event
/ka/docs/Web/API/WindowEventHandlers/onbeforeunload	/ka/docs/conflicting/Web/API/Window/beforeunload_event
/ka/docs/Web/API/WindowEventHandlers/onhashchange	/ka/docs/conflicting/Web/API/Window/hashchange_event
/ka/docs/Web/API/WindowEventHandlers/onpopstate	/ka/docs/conflicting/Web/API/Window/popstate_event
/ka/docs/Web/API/WindowEventHandlers/onunload	/ka/docs/Web/API/Window/unload_event
/ka/docs/Web/API/WindowOrWorkerGlobalScope/atob	/ka/docs/Web/API/atob
/ka/docs/Web/API/WindowOrWorkerGlobalScope/btoa	/ka/docs/Web/API/btoa
/ka/docs/Web/API/WindowOrWorkerGlobalScope/caches	/ka/docs/Web/API/caches
/ka/docs/Web/API/WindowOrWorkerGlobalScope/clearTimeout	/ka/docs/Web/API/clearTimeout
/ka/docs/Web/API/WindowOrWorkerGlobalScope/fetch	/ka/docs/Web/API/fetch
/ka/docs/Web/API/WindowOrWorkerGlobalScope/setInterval	/ka/docs/Web/API/setInterval
/ka/docs/Web/API/WindowOrWorkerGlobalScope/setTimeout	/ka/docs/Web/API/setTimeout
/ka/docs/Web/API/WindowTimers.setTimeout	/ka/docs/Web/API/setTimeout
/ka/docs/Web/API/WindowTimers/setTimeout	/ka/docs/Web/API/setTimeout
/ka/docs/Web/API/Worker/onmessage	/ka/docs/Web/API/Worker/message_event
/ka/docs/Web/API/XMLHttpRequest/onreadystatechange	/ka/docs/Web/API/XMLHttpRequest/readystatechange_event
/ka/docs/Web/API/console.timeEnd	/ka/docs/Web/API/Console/timeEnd
/ka/docs/Web/API/document.activeElement	/ka/docs/Web/API/Document/activeElement
/ka/docs/Web/API/document.createComment	/ka/docs/Web/API/Document/createComment
/ka/docs/Web/API/document.designMode	/ka/docs/Web/API/Document/designMode
/ka/docs/Web/API/document.execCommand	/ka/docs/Web/API/Document/execCommand
/ka/docs/Web/API/document.querySelector	/ka/docs/Web/API/Document/querySelector
/ka/docs/Web/API/range.getBoundingClientRect	/ka/docs/Web/API/Range/getBoundingClientRect
/ka/docs/Web/API/Видимость_страницы_API	/ka/docs/Web/API/Page_Visibility_API
/ka/docs/Web/Apps/Fundamentals/Audio_and_video_delivery	/ka/docs/Web/Guide/Audio_and_video_delivery
/ka/docs/Web/Apps/Fundamentals/Audio_and_video_delivery/Adding_captions_and_subtitles_to_HTML5_video	/ka/docs/Web/Guide/Audio_and_video_delivery/Adding_captions_and_subtitles_to_HTML5_video
/ka/docs/Web/Apps/Fundamentals/Audio_and_video_delivery/buffering_seeking_time_ranges	/ka/docs/Web/Guide/Audio_and_video_delivery/buffering_seeking_time_ranges
/ka/docs/Web/CSS/:blank	/ka/docs/Web/CSS/:-moz-only-whitespace
/ka/docs/Web/CSS/:host()	/ka/docs/Web/CSS/:host_function
/ka/docs/Web/CSS/Adjacent_sibling_selectors	/ka/docs/Web/CSS/Adjacent_sibling_combinator
/ka/docs/Web/CSS/CSS_Animations/Ispolzovanie_CSS_animatciy	/ka/docs/Web/CSS/CSS_Animations/Using_CSS_animations
/ka/docs/Web/CSS/CSS_Background_and_Borders	/ka/docs/Web/CSS/CSS_Backgrounds_and_Borders
/ka/docs/Web/CSS/CSS_Background_and_Borders/Border-image_generator	/ka/docs/Web/CSS/CSS_Backgrounds_and_Borders/Border-image_generator
/ka/docs/Web/CSS/CSS_Background_and_Borders/Border-radius_generator	/ka/docs/Web/CSS/CSS_Backgrounds_and_Borders/Border-radius_generator
/ka/docs/Web/CSS/CSS_Background_and_Borders/Border-radius_генератор	/ka/docs/Web/CSS/CSS_Backgrounds_and_Borders/Border-radius_generator
/ka/docs/Web/CSS/CSS_Background_and_Borders/Box-shadow_generator	/ka/docs/Web/CSS/CSS_Backgrounds_and_Borders/Box-shadow_generator
/ka/docs/Web/CSS/CSS_Background_and_Borders/Множественные_фоны	/ka/docs/Web/CSS/CSS_Backgrounds_and_Borders/Using_multiple_backgrounds
/ka/docs/Web/CSS/CSS_Basic_User_Interface/Using_URL_values_for_the_cursor_property	/ka/docs/conflicting/Web/CSS/cursor
/ka/docs/Web/CSS/CSS_Basic_User_Interface/Использование_URL_значений_для_свойства_cursor	/ka/docs/conflicting/Web/CSS/cursor
/ka/docs/Web/CSS/CSS_Box_Model/Box-shadow_generator	/ka/docs/Web/CSS/CSS_Backgrounds_and_Borders/Box-shadow_generator
/ka/docs/Web/CSS/CSS_Color	/ka/docs/Web/CSS/CSS_Colors
/ka/docs/Web/CSS/CSS_Flexible_Box_Layout/Выравнивание_элементов_в_Flex_контейнере	/ka/docs/Web/CSS/CSS_Flexible_Box_Layout/Aligning_Items_in_a_Flex_Container
/ka/docs/Web/CSS/CSS_Flexible_Box_Layout/Контролирование_соотношения_элементов_вдоль_главной_оси	/ka/docs/Web/CSS/CSS_Flexible_Box_Layout/Controlling_Ratios_of_Flex_Items_Along_the_Main_Ax
/ka/docs/Web/CSS/CSS_Flow_Layout/Введение_в_контексты_форматирования	/ka/docs/Web/CSS/CSS_Flow_Layout/Intro_to_formatting_contexts
/ka/docs/Web/CSS/CSS_Grid_Layout/CSS_Grid,_Logical_Values_and_Writing_Modes	/ka/docs/Web/CSS/CSS_Grid_Layout/CSS_Grid_Logical_Values_and_Writing_Modes
/ka/docs/Web/CSS/CSS_Grid_Layout/Грид-области	/ka/docs/Web/CSS/CSS_Grid_Layout/Grid_Template_Areas
/ka/docs/Web/CSS/CSS_Grid_Layout/Расположение_элементов_по_грид-линиям_с_помощью_CSS_Grid	/ka/docs/Web/CSS/CSS_Grid_Layout/Line-based_Placement_with_CSS_Grid
/ka/docs/Web/CSS/CSS_Lists_and_Counters/Using_CSS_counters	/ka/docs/Web/CSS/CSS_Counter_Styles/Using_CSS_counters
/ka/docs/Web/CSS/CSS_User_Interface/Использование_URL_значений_для_свойства_cursor	/ka/docs/conflicting/Web/CSS/cursor
/ka/docs/Web/CSS/CSS_animated_properties	/ka/docs/Web/CSS
/ka/docs/Web/CSS/CSS_Селекторы	/ka/docs/Web/CSS/CSS_Selectors
/ka/docs/Web/CSS/CSS_Селекторы/Using_the_:target_pseudo-class_in_selectors	/ka/docs/Web/CSS/CSS_Selectors/Using_the_:target_pseudo-class_in_selectors
/ka/docs/Web/CSS/Child_selectors	/ka/docs/Web/CSS/Child_combinator
/ka/docs/Web/CSS/Common_CSS_Questions	/ka/docs/Learn/CSS/Howto/CSS_FAQ
/ka/docs/Web/CSS/Descendant_selectors	/ka/docs/Web/CSS/Descendant_combinator
/ka/docs/Web/CSS/General_sibling_selectors	/ka/docs/Web/CSS/General_sibling_combinator
/ka/docs/Web/CSS/Media_Queries/Тестирование_медиа_запросы	/ka/docs/Web/CSS/Media_Queries/Testing_media_queries
/ka/docs/Web/CSS/Reference/background-blend-mode	/ka/docs/Web/CSS/background-blend-mode
/ka/docs/Web/CSS/Using_CSS_variables	/ka/docs/Web/CSS/Using_CSS_custom_properties
/ka/docs/Web/CSS/attr()	/ka/docs/Web/CSS/attr
/ka/docs/Web/CSS/box_model	/ka/docs/Web/CSS/CSS_Box_Model/Introduction_to_the_CSS_box_model
/ka/docs/Web/CSS/calc()	/ka/docs/Web/CSS/calc
/ka/docs/Web/CSS/clamp()	/ka/docs/Web/CSS/clamp
/ka/docs/Web/CSS/filter-function/blur()	/ka/docs/Web/CSS/filter-function/blur
/ka/docs/Web/CSS/minmax()	/ka/docs/Web/CSS/minmax
/ka/docs/Web/CSS/transform-function/rotate()	/ka/docs/Web/CSS/transform-function/rotate
/ka/docs/Web/CSS/transform-function/rotate3d()	/ka/docs/Web/CSS/transform-function/rotate3d
/ka/docs/Web/CSS/transform-function/scale3d()	/ka/docs/Web/CSS/transform-function/scale3d
/ka/docs/Web/CSS/transform-function/skew()	/ka/docs/Web/CSS/transform-function/skew
/ka/docs/Web/CSS/url()	/ka/docs/Web/CSS/url
/ka/docs/Web/CSS/var()	/ka/docs/Web/CSS/var
/ka/docs/Web/CSS/Действительное_значение	/ka/docs/Web/CSS/actual_value
/ka/docs/Web/CSS/Замещаемый_элемент	/ka/docs/Web/CSS/Replaced_element
/ka/docs/Web/CSS/Псевдо-классы	/ka/docs/Web/CSS/Pseudo-classes
/ka/docs/Web/CSS/Синтаксис	/ka/docs/Web/CSS/Syntax
/ka/docs/Web/CSS/Способ_расположения	/ka/docs/Web/CSS/Layout_mode
/ka/docs/Web/CSS/Тихий	/ka/docs/Web/CSS/Comments
/ka/docs/Web/CSS/Указанное_значение	/ka/docs/Web/CSS/specified_value
/ka/docs/Web/CSS/размер	/ka/docs/Web/CSS/length
/ka/docs/Web/Events/DOMContentLoaded	/ka/docs/Web/API/Window/DOMContentLoaded_event
/ka/docs/Web/Events/abort_(dom_abort_api)	/ka/docs/Web/API/AbortSignal/abort_event
/ka/docs/Web/Events/blur	/ka/docs/Web/API/Element/blur_event
/ka/docs/Web/Events/deviceorientation	/ka/docs/Web/API/Window/deviceorientation_event
/ka/docs/Web/Events/error	/ka/docs/Web/API/Element/error_event
/ka/docs/Web/Events/focusin	/ka/docs/Web/API/Element/focusin_event
/ka/docs/Web/Events/focusout	/ka/docs/Web/API/Element/focusout_event
/ka/docs/Web/Events/gamepadconnected	/ka/docs/Web/API/Window/gamepadconnected_event
/ka/docs/Web/Events/gamepaddisconnected	/ka/docs/Web/API/Window/gamepaddisconnected_event
/ka/docs/Web/Events/hashchange	/ka/docs/Web/API/Window/hashchange_event
/ka/docs/Web/Events/invalid	/ka/docs/Web/API/HTMLInputElement/invalid_event
/ka/docs/Web/Events/keypress	/ka/docs/Web/API/Element/keypress_event
/ka/docs/Web/Events/load	/ka/docs/Web/API/Window/load_event
/ka/docs/Web/Events/loadstart	/ka/docs/Web/API/XMLHttpRequest/loadstart_event
/ka/docs/Web/Events/mousedown	/ka/docs/Web/API/Element/mousedown_event
/ka/docs/Web/Events/mouseleave	/ka/docs/Web/API/Element/mouseleave_event
/ka/docs/Web/Events/popstate	/ka/docs/Web/API/Window/popstate_event
/ka/docs/Web/Events/readystatechange	/ka/docs/Web/API/Document/readystatechange_event
/ka/docs/Web/Events/resize	/ka/docs/Web/API/Window/resize_event
/ka/docs/Web/Events/scroll	/ka/docs/Web/API/Document/scroll_event
/ka/docs/Web/Events/storage	/ka/docs/Web/API/Window/storage_event
/ka/docs/Web/Events/transitionend	/ka/docs/Web/API/Element/transitionend_event
/ka/docs/Web/Events/unhandledrejection	/ka/docs/Web/API/Window/unhandledrejection_event
/ka/docs/Web/Events/стримится	/ka/docs/Web/API/HTMLMediaElement/seeking_event
/ka/docs/Web/Guide/AJAX/С_чего_начать	/ka/docs/Web/Guide/AJAX/Getting_Started
/ka/docs/Web/Guide/CSS/Getting_started/SVG_и_CSS	/ka/docs/Web/SVG/Tutorial/SVG_and_CSS
/ka/docs/Web/Guide/CSS/Understanding_z_index	/ka/docs/Web/CSS/CSS_Positioning/Understanding_z_index
/ka/docs/Web/Guide/CSS/Understanding_z_index/Adding_z-index	/ka/docs/Web/CSS/CSS_Positioning/Understanding_z_index/Adding_z-index
/ka/docs/Web/Guide/CSS/Understanding_z_index/Stacking_without_z-index	/ka/docs/Web/CSS/CSS_Positioning/Understanding_z_index/Stacking_without_z-index
/ka/docs/Web/Guide/CSS/Using_multi-column_layouts	/ka/docs/Web/CSS/CSS_Columns/Using_multi-column_layouts
/ka/docs/Web/Guide/CSS/Visual_formatting_model	/ka/docs/Web/CSS/Visual_formatting_model
/ka/docs/Web/Guide/CSS/ispolzovanie_css_animatciy	/ka/docs/Web/CSS/CSS_Animations/Using_CSS_animations
/ka/docs/Web/Guide/HTML	/ka/docs/Learn/HTML
/ka/docs/Web/Guide/HTML/Canvas_tutorial	/ka/docs/Web/API/Canvas_API/Tutorial
/ka/docs/Web/Guide/HTML/Canvas_tutorial/Basic_usage	/ka/docs/Web/API/Canvas_API/Tutorial/Basic_usage
/ka/docs/Web/Guide/HTML/Canvas_tutorial/Основы_анимации	/ka/docs/Web/API/Canvas_API/Tutorial/Basic_animations
/ka/docs/Web/Guide/HTML/Canvas_tutorial/Применение_стилей_и_цветов	/ka/docs/Web/API/Canvas_API/Tutorial/Applying_styles_and_colors
/ka/docs/Web/Guide/HTML/Canvas_tutorial/Рисование_фигур	/ka/docs/Web/API/Canvas_API/Tutorial/Drawing_shapes
/ka/docs/Web/Guide/HTML/Drag_and_drop	/ka/docs/Web/API/HTML_Drag_and_Drop_API
/ka/docs/Web/Guide/HTML/Drag_and_drop/Drag_operations	/ka/docs/Web/API/HTML_Drag_and_Drop_API/Drag_operations
/ka/docs/Web/Guide/HTML/Forms	/ka/docs/Learn/Forms
/ka/docs/Web/Guide/HTML/Introduction	/ka/docs/Learn/HTML/Introduction_to_HTML
/ka/docs/Web/Guide/HTML/Tips_for_authoring_fast-loading_HTML_pages	/ka/docs/Learn/HTML/Howto/Author_fast-loading_HTML_pages
/ka/docs/Web/Guide/HTML/Using_data_attributes	/ka/docs/Learn/HTML/Howto/Use_data_attributes
/ka/docs/Web/Guide/Графика	/ka/docs/Web/Guide/Graphics
/ka/docs/Web/Guide/Производительность	/ka/docs/Web/Guide/Performance
/ka/docs/Web/HTML/Applying_color	/ka/docs/Web/CSS/CSS_Colors/Applying_color
/ka/docs/Web/HTML/CORS_settings_attributes	/ka/docs/Web/HTML/Attributes/crossorigin
/ka/docs/Web/HTML/Canvas	/ka/docs/Web/API/Canvas_API
/ka/docs/Web/HTML/Canvas/Рисование_графики_с_помощью_Canvas	/ka/docs/Web/API/Canvas_API/Tutorial
/ka/docs/Web/HTML/Element/Input/datetime	/ka/docs/conflicting/Web/HTML/Element/input/datetime-local
/ka/docs/Web/HTML/Element/basefont	/ka/docs/conflicting/Web/CSS/CSS_Fonts_25d4b407d3e5044aeffb97faa9669a95
/ka/docs/Web/HTML/Element/video/seeking_event	/ka/docs/Web/API/HTMLMediaElement/seeking_event
/ka/docs/Web/HTML/Element/кнопка	/ka/docs/Web/HTML/Element/button
/ka/docs/Web/HTML/Element/ссылка	/ka/docs/Web/HTML/Element/link
/ka/docs/Web/HTML/Element/стиль	/ka/docs/Web/HTML/Element/style
/ka/docs/Web/HTML/Optimizing_Your_Pages_for_Speculative_Parsing	/ka/docs/Glossary/speculative_parsing
/ka/docs/Web/HTML/Использование_HTML5_audio_и_video	/ka/docs/Learn/HTML/Multimedia_and_embedding/Video_and_audio_content
/ka/docs/Web/HTML/Общие_атрибуты	/ka/docs/Web/HTML/Global_attributes
/ka/docs/Web/HTML/Общие_атрибуты/accesskey	/ka/docs/Web/HTML/Global_attributes/accesskey
/ka/docs/Web/HTML/Общие_атрибуты/class	/ka/docs/Web/HTML/Global_attributes/class
/ka/docs/Web/HTML/Общие_атрибуты/contenteditable	/ka/docs/Web/HTML/Global_attributes/contenteditable
/ka/docs/Web/HTML/Общие_атрибуты/data-*	/ka/docs/Web/HTML/Global_attributes/data-*
/ka/docs/Web/HTML/Общие_атрибуты/id	/ka/docs/Web/HTML/Global_attributes/id
/ka/docs/Web/HTML/Общие_атрибуты/inputmode	/ka/docs/Web/HTML/Global_attributes/inputmode
/ka/docs/Web/HTML/Общие_атрибуты/is	/ka/docs/Web/HTML/Global_attributes/is
/ka/docs/Web/HTML/Общие_атрибуты/itemid	/ka/docs/Web/HTML/Global_attributes/itemid
/ka/docs/Web/HTML/Общие_атрибуты/lang	/ka/docs/Web/HTML/Global_attributes/lang
/ka/docs/Web/HTML/Общие_атрибуты/style	/ka/docs/Web/HTML/Global_attributes/style
/ka/docs/Web/HTML/Общие_атрибуты/tabindex	/ka/docs/Web/HTML/Global_attributes/tabindex
/ka/docs/Web/HTML/Ссылки	/ka/docs/Web/HTML/Reference
/ka/docs/Web/HTML/Строчные_Элементы	/ka/docs/Web/HTML/Inline_elements
/ka/docs/Web/HTML/Типы_ссылок	/ka/docs/Web/HTML/Link_types
/ka/docs/Web/HTTP/Basics_of_HTTP/Data_URIs	/ka/docs/Web/HTTP/Basics_of_HTTP/Data_URLs
/ka/docs/Web/HTTP/Basics_of_HTTP/Identifying_resources_on_the_Web_ka	/ka/docs/Web/HTTP/Basics_of_HTTP/Identifying_resources_on_the_Web
/ka/docs/Web/HTTP/Basics_of_HTTP/MIME_types/Полный_список_типов_MIME	/ka/docs/Web/HTTP/Basics_of_HTTP/MIME_types/Common_types
/ka/docs/Web/HTTP/Response_codes	/ka/docs/Web/HTTP/Status
/ka/docs/Web/HTTP/Авторизация	/ka/docs/Web/HTTP/Authentication
/ka/docs/Web/HTTP/Заголовки	/ka/docs/Web/HTTP/Headers
/ka/docs/Web/HTTP/Заголовки/Accept	/ka/docs/Web/HTTP/Headers/Accept
/ka/docs/Web/HTTP/Заголовки/Accept-Charset	/ka/docs/Web/HTTP/Headers/Accept-Charset
/ka/docs/Web/HTTP/Заголовки/Accept-Language	/ka/docs/Web/HTTP/Headers/Accept-Language
/ka/docs/Web/HTTP/Заголовки/Accept-Patch	/ka/docs/Web/HTTP/Headers/Accept-Patch
/ka/docs/Web/HTTP/Заголовки/Accept-Ranges	/ka/docs/Web/HTTP/Headers/Accept-Ranges
/ka/docs/Web/HTTP/Заголовки/Access-Control-Allow-Headers	/ka/docs/Web/HTTP/Headers/Access-Control-Allow-Headers
/ka/docs/Web/HTTP/Заголовки/Access-Control-Allow-Methods	/ka/docs/Web/HTTP/Headers/Access-Control-Allow-Methods
/ka/docs/Web/HTTP/Заголовки/Access-Control-Allow-Origin	/ka/docs/Web/HTTP/Headers/Access-Control-Allow-Origin
/ka/docs/Web/HTTP/Заголовки/Access-Control-Max-Age	/ka/docs/Web/HTTP/Headers/Access-Control-Max-Age
/ka/docs/Web/HTTP/Заголовки/Authorization	/ka/docs/Web/HTTP/Headers/Authorization
/ka/docs/Web/HTTP/Заголовки/Cache-Control	/ka/docs/Web/HTTP/Headers/Cache-Control
/ka/docs/Web/HTTP/Заголовки/Connection	/ka/docs/Web/HTTP/Headers/Connection
/ka/docs/Web/HTTP/Заголовки/Content-Disposition	/ka/docs/Web/HTTP/Headers/Content-Disposition
/ka/docs/Web/HTTP/Заголовки/Content-Encoding	/ka/docs/Web/HTTP/Headers/Content-Encoding
/ka/docs/Web/HTTP/Заголовки/Content-Language	/ka/docs/Web/HTTP/Headers/Content-Language
/ka/docs/Web/HTTP/Заголовки/Content-Length	/ka/docs/Web/HTTP/Headers/Content-Length
/ka/docs/Web/HTTP/Заголовки/Content-Type	/ka/docs/Web/HTTP/Headers/Content-Type
/ka/docs/Web/HTTP/Заголовки/DNT	/ka/docs/Web/HTTP/Headers/DNT
/ka/docs/Web/HTTP/Заголовки/Date	/ka/docs/Web/HTTP/Headers/Date
/ka/docs/Web/HTTP/Заголовки/ETag	/ka/docs/Web/HTTP/Headers/ETag
/ka/docs/Web/HTTP/Заголовки/Expect	/ka/docs/Web/HTTP/Headers/Expect
/ka/docs/Web/HTTP/Заголовки/Expires	/ka/docs/Web/HTTP/Headers/Expires
/ka/docs/Web/HTTP/Заголовки/Host	/ka/docs/Web/HTTP/Headers/Host
/ka/docs/Web/HTTP/Заголовки/If-Match	/ka/docs/Web/HTTP/Headers/If-Match
/ka/docs/Web/HTTP/Заголовки/If-Modified-Since	/ka/docs/Web/HTTP/Headers/If-Modified-Since
/ka/docs/Web/HTTP/Заголовки/If-Unmodified-Since	/ka/docs/Web/HTTP/Headers/If-Unmodified-Since
/ka/docs/Web/HTTP/Заголовки/Last-Modified	/ka/docs/Web/HTTP/Headers/Last-Modified
/ka/docs/Web/HTTP/Заголовки/Origin	/ka/docs/Web/HTTP/Headers/Origin
/ka/docs/Web/HTTP/Заголовки/Pragma	/ka/docs/Web/HTTP/Headers/Pragma
/ka/docs/Web/HTTP/Заголовки/Range	/ka/docs/Web/HTTP/Headers/Range
/ka/docs/Web/HTTP/Заголовки/Referer	/ka/docs/Web/HTTP/Headers/Referer
/ka/docs/Web/HTTP/Заголовки/Retry-After	/ka/docs/Web/HTTP/Headers/Retry-After
/ka/docs/Web/HTTP/Заголовки/Set-Cookie	/ka/docs/Web/HTTP/Headers/Set-Cookie
/ka/docs/Web/HTTP/Заголовки/Strict-Transport-Security	/ka/docs/Web/HTTP/Headers/Strict-Transport-Security
/ka/docs/Web/HTTP/Заголовки/Vary	/ka/docs/Web/HTTP/Headers/Vary
/ka/docs/Web/HTTP/Заголовки/X-Content-Type-Options	/ka/docs/Web/HTTP/Headers/X-Content-Type-Options
/ka/docs/Web/HTTP/Заголовки/X-Forwarded-For	/ka/docs/Web/HTTP/Headers/X-Forwarded-For
/ka/docs/Web/HTTP/Заголовки/X-XSS-Protection	/ka/docs/Web/HTTP/Headers/X-XSS-Protection
/ka/docs/Web/HTTP/Куки	/ka/docs/Web/HTTP/Cookies
/ka/docs/Web/HTTP/Кэширование	/ka/docs/Web/HTTP/Caching
/ka/docs/Web/JavaScript/Guide/Closures	/ka/docs/Web/JavaScript/Closures
/ka/docs/Web/JavaScript/Guide/Details_of_the_Object_Model	/ka/docs/conflicting/Web/JavaScript/Inheritance_and_the_prototype_chain
/ka/docs/Web/JavaScript/Guide/EventLoop	/ka/docs/Web/JavaScript/EventLoop
/ka/docs/Web/JavaScript/Guide/Inheritance_and_the_prototype_chain	/ka/docs/Web/JavaScript/Inheritance_and_the_prototype_chain
/ka/docs/Web/JavaScript/Guide/Ispolzovanie_promisov	/ka/docs/Web/JavaScript/Guide/Using_promises
/ka/docs/Web/JavaScript/Guide/Statements	/ka/docs/Web/JavaScript/Guide/Control_flow_and_error_handling
/ka/docs/Web/JavaScript/Guide/The_Iterator_protocol	/ka/docs/Web/JavaScript/Reference/Iteration_protocols
/ka/docs/Web/JavaScript/Guide/Values,_variables,_and_literals	/ka/docs/Web/JavaScript/Guide/Grammar_and_types
/ka/docs/Web/JavaScript/Guide/Введение_в_JavaScript	/ka/docs/Web/JavaScript/Guide/Introduction
/ka/docs/Web/JavaScript/Guide/Циклы_и_итерации	/ka/docs/Web/JavaScript/Guide/Loops_and_iteration
/ka/docs/Web/JavaScript/Guide_ka	/ka/docs/Web/JavaScript/Guide
/ka/docs/Web/JavaScript/Guide_ka/Expressions_and_Operators	/ka/docs/Web/JavaScript/Guide/Expressions_and_Operators
/ka/docs/Web/JavaScript/Guide_ka/Functions	/ka/docs/Web/JavaScript/Guide/Functions
/ka/docs/Web/JavaScript/Guide_ka/Inheritance_and_the_prototype_chain_ka	/ka/docs/Web/JavaScript/Inheritance_and_the_prototype_chain
/ka/docs/Web/JavaScript/Guide_ka/Regular_Expressions	/ka/docs/Web/JavaScript/Guide/Regular_Expressions
/ka/docs/Web/JavaScript/Guide_ka/Statements	/ka/docs/Web/JavaScript/Guide/Control_flow_and_error_handling
/ka/docs/Web/JavaScript/Guide_ka/Values,_variables,_and_literals	/ka/docs/Web/JavaScript/Guide/Grammar_and_types
/ka/docs/Web/JavaScript/Guide_ka/Working_with_Objects	/ka/docs/Web/JavaScript/Guide/Working_with_Objects
/ka/docs/Web/JavaScript/Guide_ka/Замыкания	/ka/docs/Web/JavaScript/Closures
/ka/docs/Web/JavaScript/JavaScript_шеллы	/ka/docs/Web/JavaScript/Shells
/ka/docs/Web/JavaScript/Language_Resources	/ka/docs/conflicting/Web/JavaScript/JavaScript_technologies_overview
/ka/docs/Web/JavaScript/Reference/Classes/Class_fields	/ka/docs/Web/JavaScript/Reference/Classes/Public_class_fields
/ka/docs/Web/JavaScript/Reference/Classes/Приватные_поля_класса	/ka/docs/Web/JavaScript/Reference/Classes/Private_class_fields
/ka/docs/Web/JavaScript/Reference/Errors/Cant_access_property	/ka/docs/conflicting/Web/JavaScript/Reference/Errors/Unexpected_type
/ka/docs/Web/JavaScript/Reference/Errors/Переменные_скрывают_аргумент	/ka/docs/Web/JavaScript/Reference/Errors/Var_hides_argument
/ka/docs/Web/JavaScript/Reference/Functions/Определиние_методов	/ka/docs/Web/JavaScript/Reference/Functions/Method_definitions
/ka/docs/Web/JavaScript/Reference/Global_Objects/Array/contains	/ka/docs/Web/JavaScript/Reference/Global_Objects/Array/includes
/ka/docs/Web/JavaScript/Reference/Global_Objects/Array/toSource	/ka/docs/conflicting/Web/JavaScript/Reference/Global_Objects/Array/toString
/ka/docs/Web/JavaScript/Reference/Global_Objects/Boolean/toSource	/ka/docs/conflicting/Web/JavaScript/Reference/Global_Objects/Boolean/toString
/ka/docs/Web/JavaScript/Reference/Global_Objects/Collator	/ka/docs/Web/JavaScript/Reference/Global_Objects/Intl/Collator
/ka/docs/Web/JavaScript/Reference/Global_Objects/Collator/compare	/ka/docs/Web/JavaScript/Reference/Global_Objects/Intl/Collator/compare
/ka/docs/Web/JavaScript/Reference/Global_Objects/Collator/resolvedOptions	/ka/docs/Web/JavaScript/Reference/Global_Objects/Intl/Collator/resolvedOptions
/ka/docs/Web/JavaScript/Reference/Global_Objects/Collator/supportedLocalesOf	/ka/docs/Web/JavaScript/Reference/Global_Objects/Intl/Collator/supportedLocalesOf
/ka/docs/Web/JavaScript/Reference/Global_Objects/Date/toSource	/ka/docs/conflicting/Web/JavaScript/Reference/Global_Objects/Date/toString
/ka/docs/Web/JavaScript/Reference/Global_Objects/DateTimeFormat	/ka/docs/Web/JavaScript/Reference/Global_Objects/Intl/DateTimeFormat
/ka/docs/Web/JavaScript/Reference/Global_Objects/DateTimeFormat/format	/ka/docs/Web/JavaScript/Reference/Global_Objects/Intl/DateTimeFormat/format
/ka/docs/Web/JavaScript/Reference/Global_Objects/DateTimeFormat/formatToParts	/ka/docs/Web/JavaScript/Reference/Global_Objects/Intl/DateTimeFormat/formatToParts
/ka/docs/Web/JavaScript/Reference/Global_Objects/DateTimeFormat/resolvedOptions	/ka/docs/Web/JavaScript/Reference/Global_Objects/Intl/DateTimeFormat/resolvedOptions
/ka/docs/Web/JavaScript/Reference/Global_Objects/DateTimeFormat/supportedLocalesOf	/ka/docs/Web/JavaScript/Reference/Global_Objects/Intl/DateTimeFormat/supportedLocalesOf
/ka/docs/Web/JavaScript/Reference/Global_Objects/Error/toSource	/ka/docs/conflicting/Web/JavaScript/Reference/Global_Objects/Error/toString
/ka/docs/Web/JavaScript/Reference/Global_Objects/Function/toSource	/ka/docs/conflicting/Web/JavaScript/Reference/Global_Objects/Function/toString
/ka/docs/Web/JavaScript/Reference/Global_Objects/ListFormat	/ka/docs/Web/JavaScript/Reference/Global_Objects/Intl/ListFormat
/ka/docs/Web/JavaScript/Reference/Global_Objects/Number/toSource	/ka/docs/conflicting/Web/JavaScript/Reference/Global_Objects/Number/toString
/ka/docs/Web/JavaScript/Reference/Global_Objects/NumberFormat	/ka/docs/Web/JavaScript/Reference/Global_Objects/Intl/NumberFormat
/ka/docs/Web/JavaScript/Reference/Global_Objects/NumberFormat/format	/ka/docs/Web/JavaScript/Reference/Global_Objects/Intl/NumberFormat/format
/ka/docs/Web/JavaScript/Reference/Global_Objects/NumberFormat/resolvedOptions	/ka/docs/Web/JavaScript/Reference/Global_Objects/Intl/NumberFormat/resolvedOptions
/ka/docs/Web/JavaScript/Reference/Global_Objects/NumberFormat/supportedLocalesOf	/ka/docs/Web/JavaScript/Reference/Global_Objects/Intl/NumberFormat/supportedLocalesOf
/ka/docs/Web/JavaScript/Reference/Global_Objects/Object/toSource	/ka/docs/conflicting/Web/JavaScript/Reference/Global_Objects/Object/toString
/ka/docs/Web/JavaScript/Reference/Global_Objects/Proxy/handler/deleteProperty	/ka/docs/Web/JavaScript/Reference/Global_Objects/Proxy/Proxy/deleteProperty
/ka/docs/Web/JavaScript/Reference/Global_Objects/Proxy/handler/set	/ka/docs/Web/JavaScript/Reference/Global_Objects/Proxy/Proxy/set
/ka/docs/Web/JavaScript/Reference/Global_Objects/RegExp/toSource	/ka/docs/conflicting/Web/JavaScript/Reference/Global_Objects/RegExp/toString
/ka/docs/Web/JavaScript/Reference/Global_Objects/String/TrimLeft	/ka/docs/Web/JavaScript/Reference/Global_Objects/String/trimStart
/ka/docs/Web/JavaScript/Reference/Global_Objects/String/TrimRight	/ka/docs/Web/JavaScript/Reference/Global_Objects/String/trimEnd
/ka/docs/Web/JavaScript/Reference/Global_Objects/String/contains	/ka/docs/Web/JavaScript/Reference/Global_Objects/String/includes
/ka/docs/Web/JavaScript/Reference/Global_Objects/String/toSource	/ka/docs/conflicting/Web/JavaScript/Reference/Global_Objects/String/toString
/ka/docs/Web/JavaScript/Reference/Global_Objects/null	/ka/docs/Web/JavaScript/Reference/Operators/null
/ka/docs/Web/JavaScript/Reference/Global_Objects/uneval	/ka/docs/conflicting/Web/JavaScript/Reference/Global_Objects
/ka/docs/Web/JavaScript/Reference/Methods_Index	/ka/docs/Web/JavaScript/Reference
/ka/docs/Web/JavaScript/Reference/Operators/Spread_operator	/ka/docs/Web/JavaScript/Reference/Operators/Spread_syntax
/ka/docs/Web/JavaScript/Reference/Operators/Группировка	/ka/docs/Web/JavaScript/Reference/Operators/Grouping
/ka/docs/Web/JavaScript/Reference/Operators/Оператор_Запятая	/ka/docs/Web/JavaScript/Reference/Operators/Comma_Operator
/ka/docs/Web/JavaScript/Reference/Operators/Присваивание	/ka/docs/Web/JavaScript/Reference/Operators/Assignment
/ka/docs/Web/JavaScript/Reference/Operators/Условный_оператор	/ka/docs/Web/JavaScript/Reference/Operators/Conditional_Operator
/ka/docs/Web/JavaScript/Reference/Properties_Index	/ka/docs/Web/JavaScript/Reference
/ka/docs/Web/JavaScript/Reference/Statements/import.meta	/ka/docs/Web/JavaScript/Reference/Operators/import.meta
/ka/docs/Web/JavaScript/Reference/Statements/Блок	/ka/docs/Web/JavaScript/Reference/Statements/block
/ka/docs/Web/JavaScript/Reference/template_strings	/ka/docs/Web/JavaScript/Reference/Template_literals
/ka/docs/Web/JavaScript/Reference/Об	/ka/docs/Web/JavaScript/Reference/About
/ka/docs/Web/JavaScript/О_JavaScript	/ka/docs/Web/JavaScript/About_JavaScript
/ka/docs/Web/JavaScript/ცნობარი_JavaScript_1.5	/ka/docs/Web/JavaScript/Reference
/ka/docs/Web/JavaScript/ცნობარი_JavaScript_1.5/Methods_Index	/ka/docs/Web/JavaScript/Reference
/ka/docs/Web/JavaScript/ცნობარი_JavaScript_1.5/Operators	/ka/docs/Web/JavaScript/Reference/Operators
/ka/docs/Web/JavaScript/ცნობარი_JavaScript_1.5/Operators/Operator_Precedence	/ka/docs/Web/JavaScript/Reference/Operators/Operator_Precedence
/ka/docs/Web/JavaScript/ცნობარი_JavaScript_1.5/Operators/delete	/ka/docs/Web/JavaScript/Reference/Operators/delete
/ka/docs/Web/JavaScript/ცნობარი_JavaScript_1.5/Operators/function	/ka/docs/Web/JavaScript/Reference/Operators/function
/ka/docs/Web/JavaScript/ცნობარი_JavaScript_1.5/Operators/typeof	/ka/docs/Web/JavaScript/Reference/Operators/typeof
/ka/docs/Web/JavaScript/ცნობარი_JavaScript_1.5/Operators/Оператор_Запятая	/ka/docs/Web/JavaScript/Reference/Operators/Comma_Operator
/ka/docs/Web/JavaScript/ცნობარი_JavaScript_1.5/Properties_Index	/ka/docs/Web/JavaScript/Reference
/ka/docs/Web/JavaScript/ცნობარი_JavaScript_1.5/Statements	/ka/docs/Web/JavaScript/Reference/Statements
/ka/docs/Web/JavaScript/ცნობარი_JavaScript_1.5/Statements/let	/ka/docs/Web/JavaScript/Reference/Statements/let
/ka/docs/Web/JavaScript/ცნობარი_JavaScript_1.5/გლობალური_ობიექტები	/ka/docs/Web/JavaScript/Reference/Global_Objects
/ka/docs/Web/JavaScript/ცნობარი_JavaScript_1.5/გლობალური_ობიექტები/Array	/ka/docs/Web/JavaScript/Reference/Global_Objects/Array
/ka/docs/Web/JavaScript/ცნობარი_JavaScript_1.5/გლობალური_ობიექტები/Array/Array	/ka/docs/Web/JavaScript/Reference/Global_Objects/Array
/ka/docs/Web/JavaScript/ცნობარი_JavaScript_1.5/გლობალური_ობიექტები/Array/MDC	/ka/docs/Web/JavaScript/Reference/Global_Objects/Array
/ka/docs/Web/JavaScript/ცნობარი_JavaScript_1.5/გლობალური_ობიექტები/Array/map	/ka/docs/Web/JavaScript/Reference/Global_Objects/Array/map
/ka/docs/Web/JavaScript/ცნობარი_JavaScript_1.5/გლობალური_ობიექტები/Boolean	/ka/docs/Web/JavaScript/Reference/Global_Objects/Boolean
/ka/docs/Web/JavaScript/ცნობარი_JavaScript_1.5/გლობალური_ობიექტები/Function	/ka/docs/Web/JavaScript/Reference/Global_Objects/Function
/ka/docs/Web/JavaScript/ცნობარი_JavaScript_1.5/გლობალური_ობიექტები/Function/bind	/ka/docs/Web/JavaScript/Reference/Global_Objects/Function/bind
/ka/docs/Web/JavaScript/ცნობარი_JavaScript_1.5/გლობალური_ობიექტები/Function/call	/ka/docs/Web/JavaScript/Reference/Global_Objects/Function/call
/ka/docs/Web/JavaScript/ცნობარი_JavaScript_1.5/გლობალური_ობიექტები/Function/length	/ka/docs/Web/JavaScript/Reference/Global_Objects/Function/length
/ka/docs/Web/JavaScript/ცნობარი_JavaScript_1.5/გლობალური_ობიექტები/Function/name	/ka/docs/Web/JavaScript/Reference/Global_Objects/Function/name
/ka/docs/Web/JavaScript/ცნობარი_JavaScript_1.5/გლობალური_ობიექტები/Math	/ka/docs/Web/JavaScript/Reference/Global_Objects/Math
/ka/docs/Web/JavaScript/ცნობარი_JavaScript_1.5/გლობალური_ობიექტები/Object	/ka/docs/Web/JavaScript/Reference/Global_Objects/Object
/ka/docs/Web/JavaScript/ცნობარი_JavaScript_1.5/გლობალური_ობიექტები/RegExp	/ka/docs/Web/JavaScript/Reference/Global_Objects/RegExp
/ka/docs/Web/JavaScript/ცნობარი_JavaScript_1.5/გლობალური_ფუნქციები	/ka/docs/Web/JavaScript/Reference/Global_Objects
/ka/docs/Web/JavaScript/ცნობარი_JavaScript_1.5/გლობალური_ფუნქციები/String	/ka/docs/Web/JavaScript/Reference/Global_Objects/String
/ka/docs/Web/JavaScript/ცნობარი_JavaScript_1.5/გლობალური_ფუნქციები/isNaN	/ka/docs/Web/JavaScript/Reference/Global_Objects/isNaN
/ka/docs/Web/JavaScript/ცნობარი_JavaScript_1.5/Операторы	/ka/docs/Web/JavaScript/Reference/Operators
/ka/docs/Web/JavaScript/ცნობარი_JavaScript_1.5/Операции	/ka/docs/Web/JavaScript/Reference/Operators
/ka/docs/Web/JavaScript/ცნობარი_JavaScript_1.5/Операции/Assignment_Operators	/ka/docs/Web/JavaScript/Reference/Operators
/ka/docs/Web/Manifest/dir	/ka/docs/conflicting/Web/Manifest
/ka/docs/Web/Manifest/iarc_rating_id	/ka/docs/conflicting/Web/Manifest_e8c4835b067e177a000dc29c18483205
/ka/docs/Web/Manifest/lang	/ka/docs/conflicting/Web/Manifest_7ec32c6987e59d5f1cb08f8c9d900a4c
/ka/docs/Web/MathML/Атрибут	/ka/docs/Web/MathML/Attribute
/ka/docs/Web/MathML/Примеры	/ka/docs/Web/MathML/Examples
/ka/docs/Web/MathML/Примеры/Deriving_the_Quadratic_Formula	/ka/docs/Web/MathML/Examples/Deriving_the_Quadratic_Formula
/ka/docs/Web/MathML/Примеры/MathML_Pythagorean_Theorem	/ka/docs/Web/MathML/Examples/MathML_Pythagorean_Theorem
/ka/docs/Web/Media/Formats/WebRTC_кодеки	/ka/docs/Web/Media/Formats/WebRTC_codecs
/ka/docs/Web/Performance/Основы	/ka/docs/Web/Performance/Fundamentals
/ka/docs/Web/Performance/Производительность_анимации	/ka/docs/Web/Performance/Animation_performance_and_frame_rate
/ka/docs/Web/SVG/Tutorial/Базовые_Преобразования	/ka/docs/Web/SVG/Tutorial/Basic_Transformations
/ka/docs/Web/SVG/Tutorial/Введение	/ka/docs/Web/SVG/Tutorial/Introduction
/ka/docs/Web/SVG/Tutorial/Основные_Фигуры	/ka/docs/Web/SVG/Tutorial/Basic_Shapes
/ka/docs/Web/SVG/Tutorial/Позиции	/ka/docs/Web/SVG/Tutorial/Positions
/ka/docs/Web/SVG/Элемент	/ka/docs/Web/SVG/Element
/ka/docs/Web/SVG/Элемент/<text>	/ka/docs/Web/SVG/Element/text
/ka/docs/Web/SVG/Элемент/a	/ka/docs/Web/SVG/Element/a
/ka/docs/Web/SVG/Элемент/animate	/ka/docs/Web/SVG/Element/animate
/ka/docs/Web/SVG/Элемент/animateMotion	/ka/docs/Web/SVG/Element/animateMotion
/ka/docs/Web/SVG/Элемент/circle	/ka/docs/Web/SVG/Element/circle
/ka/docs/Web/SVG/Элемент/defs	/ka/docs/Web/SVG/Element/defs
/ka/docs/Web/SVG/Элемент/ellipse	/ka/docs/Web/SVG/Element/ellipse
/ka/docs/Web/SVG/Элемент/feBlend	/ka/docs/Web/SVG/Element/feBlend
/ka/docs/Web/SVG/Элемент/foreignObject	/ka/docs/Web/SVG/Element/foreignObject
/ka/docs/Web/SVG/Элемент/g	/ka/docs/Web/SVG/Element/g
/ka/docs/Web/SVG/Элемент/image	/ka/docs/Web/SVG/Element/image
/ka/docs/Web/SVG/Элемент/line	/ka/docs/Web/SVG/Element/line
/ka/docs/Web/SVG/Элемент/linearGradient	/ka/docs/Web/SVG/Element/linearGradient
/ka/docs/Web/SVG/Элемент/path	/ka/docs/Web/SVG/Element/path
/ka/docs/Web/SVG/Элемент/pattern	/ka/docs/Web/SVG/Element/pattern
/ka/docs/Web/SVG/Элемент/polygon	/ka/docs/Web/SVG/Element/polygon
/ka/docs/Web/SVG/Элемент/radialGradient	/ka/docs/Web/SVG/Element/radialGradient
/ka/docs/Web/SVG/Элемент/rect	/ka/docs/Web/SVG/Element/rect
/ka/docs/Web/SVG/Элемент/svg	/ka/docs/Web/SVG/Element/svg
/ka/docs/Web/SVG/Элемент/use	/ka/docs/Web/SVG/Element/use
/ka/docs/Web/WebGL	/ka/docs/Web/API/WebGL_API
/ka/docs/Web/WebGL/Adding_2D_content_to_a_WebGL_context	/ka/docs/Web/API/WebGL_API/Tutorial/Adding_2D_content_to_a_WebGL_context
/ka/docs/Web/WebGL/Animating_objects_with_WebGL	/ka/docs/Web/API/WebGL_API/Tutorial/Animating_objects_with_WebGL
/ka/docs/Web/WebGL/Getting_started_with_WebGL	/ka/docs/Web/API/WebGL_API/Tutorial/Getting_started_with_WebGL
/ka/docs/Web/WebGL/Using_shaders_to_apply_color_in_WebGL	/ka/docs/Web/API/WebGL_API/Tutorial/Using_shaders_to_apply_color_in_WebGL
/ka/docs/Web/Web_Components/HTML_Imports	/ka/docs/conflicting/Web/Web_Components
/ka/docs/Web/Web_Components/Использование_пользовательских_элементов	/ka/docs/Web/Web_Components/Using_custom_elements
/ka/docs/Web/XPath/Funkcje	/ka/docs/Web/XPath/Functions
/ka/docs/Web/XPath/Funkcje/floor	/ka/docs/Web/XPath/Functions/floor
/ka/docs/Web/Манифест	/ka/docs/Web/Manifest
/ka/docs/Web/Манифест/background_color	/ka/docs/Web/Manifest/background_color
/ka/docs/Web/Манифест/categories	/ka/docs/Web/Manifest/categories
/ka/docs/Web/Манифест/description	/ka/docs/Web/Manifest/description
/ka/docs/Web/Манифест/dir	/ka/docs/conflicting/Web/Manifest
/ka/docs/Web/Манифест/display	/ka/docs/Web/Manifest/display
/ka/docs/Web/Манифест/iarc_rating_id	/ka/docs/conflicting/Web/Manifest_e8c4835b067e177a000dc29c18483205
/ka/docs/Web/Манифест/icons	/ka/docs/Web/Manifest/icons
/ka/docs/Web/Манифест/lang	/ka/docs/conflicting/Web/Manifest_7ec32c6987e59d5f1cb08f8c9d900a4c
/ka/docs/Web/Манифест/name	/ka/docs/Web/Manifest/name
/ka/docs/Web/Манифест/orientation	/ka/docs/Web/Manifest/orientation
/ka/docs/Web/Манифест/prefer_related_applications	/ka/docs/Web/Manifest/prefer_related_applications
/ka/docs/Web/Манифест/related_applications	/ka/docs/Web/Manifest/related_applications
/ka/docs/Web/Манифест/scope	/ka/docs/Web/Manifest/scope
/ka/docs/Web/Манифест/screenshots	/ka/docs/Web/Manifest/screenshots
/ka/docs/Web/Манифест/short_name	/ka/docs/Web/Manifest/short_name
/ka/docs/Web/Манифест/start_url	/ka/docs/Web/Manifest/start_url
/ka/docs/Web/Манифест/theme_color	/ka/docs/Web/Manifest/theme_color
/ka/docs/WebGL	/ka/docs/Web/API/WebGL_API
/ka/docs/WebGL/Using_shaders_to_apply_color_in_WebGL	/ka/docs/Web/API/WebGL_API/Tutorial/Using_shaders_to_apply_color_in_WebGL
/ka/docs/WebSockets	/ka/docs/Web/API/WebSockets_API
/ka/docs/WebSockets/Writing_WebSocket_client_applications	/ka/docs/Web/API/WebSockets_API/Writing_WebSocket_client_applications
/ka/docs/XHTML	/ka/docs/Glossary/XHTML
/ka/docs/XPath	/ka/docs/Web/XPath
/ka/docs/XPath/Funkcje	/ka/docs/Web/XPath/Functions
/ka/docs/XPath/Funkcje/floor	/ka/docs/Web/XPath/Functions/floor
/ka/docs/XSLT	/ka/docs/Web/XSLT
/ka/docs/conflicting/Tools	https://firefox-source-docs.mozilla.org/devtools-user/index.html
/ka/docs/en	/en-US/
/ka/docs/Заглавная_страница	/ka/docs/Web
/ka/docs/Повторное_введение_в_JavaScript	/ka/docs/Web/JavaScript/A_re-introduction_to_JavaScript
/ka/docs/Руководство_по_JavaScript_1.5	/ka/docs/Web/JavaScript/Guide
/ka/docs/Руководство_по_JavaScript_1.5/Операторы	/ka/docs/Web/JavaScript/Reference/Operators
/ka/docs/Руководство_по_JavaScript_1.5/Операторы/Специальные_операторы	/ka/docs/Web/JavaScript/Reference/Operators
/ka/docs/Руководство_по_JavaScript_1.5/Операторы/Специальные_операторы/Оператор_get	/ka/docs/Web/JavaScript/Reference/Operators
/ka/docs/Руководство_по_JavaScript_1.5/Функции	/ka/docs/Web/JavaScript/Guide/Functions
/ka/docs/Руководство_по_JavaScript_1.5:Функции	/ka/docs/Web/JavaScript/Guide/Functions
/ka/docs/ლექსიკონი	/ka/docs/Glossary
/ka/docs/ლექსიკონი/404	/ka/docs/conflicting/Web/HTTP/Status/404
/ka/docs/ლექსიკონი/502	/ka/docs/conflicting/Web/HTTP/Status/502
/ka/docs/ლექსიკონი/AJAX	/ka/docs/Glossary/AJAX
/ka/docs/ლექსიკონი/AOM	/ka/docs/Glossary/Accessibility_tree
/ka/docs/ლექსიკონი/API	/ka/docs/Glossary/API
/ka/docs/ლექსიკონი/ARIA	/ka/docs/Glossary/ARIA
/ka/docs/ლექსიკონი/ARPA	/ka/docs/Glossary/ARPA
/ka/docs/ლექსიკონი/ASCII	/ka/docs/Glossary/ASCII
/ka/docs/ლექსიკონი/ATAG	/ka/docs/Glossary/ATAG
/ka/docs/ლექსიკონი/Abstraction	/ka/docs/Glossary/Abstraction
/ka/docs/ლექსიკონი/Adobe-Flash	/ka/docs/Glossary/Adobe_Flash
/ka/docs/ლექსიკონი/Algorithm	/ka/docs/Glossary/Algorithm
/ka/docs/ლექსიკონი/Apple_Safari	/ka/docs/Glossary/Apple_Safari
/ka/docs/ლექსიკონი/Arpanet	/ka/docs/Glossary/Arpanet
/ka/docs/ლექსიკონი/Asynchronous	/ka/docs/Glossary/Asynchronous
/ka/docs/ლექსიკონი/Bandwidth	/ka/docs/Glossary/Bandwidth
/ka/docs/ლექსიკონი/BiDi	/ka/docs/Glossary/BiDi
/ka/docs/ლექსიკონი/BigInt	/ka/docs/Glossary/BigInt
/ka/docs/ლექსიკონი/Blink	/ka/docs/Glossary/Blink
/ka/docs/ლექსიკონი/Boolean	/ka/docs/Glossary/Boolean
/ka/docs/ლექსიკონი/Bootstrap	/ka/docs/Glossary/Bootstrap
/ka/docs/ლექსიკონი/Browser	/ka/docs/Glossary/Browser
/ka/docs/ლექსიკონი/Browsing_context	/ka/docs/Glossary/Browsing_context
/ka/docs/ლექსიკონი/Bézier_curve	/ka/docs/Glossary/Bezier_curve
/ka/docs/ლექსიკონი/CDN	/ka/docs/Glossary/CDN
/ka/docs/ლექსიკონი/CMS	/ka/docs/Glossary/CMS
/ka/docs/ლექსიკონი/CORS	/ka/docs/Glossary/CORS
/ka/docs/ლექსიკონი/CRLF	/ka/docs/Glossary/CRLF
/ka/docs/ლექსიკონი/CSP	/ka/docs/Glossary/CSP
/ka/docs/ლექსიკონი/CSRF	/ka/docs/Glossary/CSRF
/ka/docs/ლექსიკონი/CSS	/ka/docs/Glossary/CSS
/ka/docs/ლექსიკონი/CSS_Selector	/ka/docs/Glossary/CSS_Selector
/ka/docs/ლექსიკონი/CSS_preprocessor	/ka/docs/Glossary/CSS_preprocessor
/ka/docs/ლექსიკონი/Call_stack	/ka/docs/Glossary/Call_stack
/ka/docs/ლექსიკონი/Canvas	/ka/docs/Glossary/Canvas
/ka/docs/ლექსიკონი/Card_sorting	/ka/docs/Glossary/Card_sorting
/ka/docs/ლექსიკონი/Character	/ka/docs/Glossary/Character
/ka/docs/ლექსიკონი/Chrome	/ka/docs/Glossary/Chrome
/ka/docs/ლექსიკონი/Class	/ka/docs/Glossary/Class
/ka/docs/ლექსიკონი/Codec	/ka/docs/Glossary/Codec
/ka/docs/ლექსიკონი/Compile	/ka/docs/Glossary/Compile
/ka/docs/ლექსიკონი/Computer_Programming	/ka/docs/Glossary/Computer_Programming
/ka/docs/ლექსიკონი/Conditional	/ka/docs/Glossary/Conditional
/ka/docs/ლექსიკონი/Constkactor	/ka/docs/Glossary/Constkactor
/ka/docs/ლექსიკონი/Cookie	/ka/docs/Glossary/Cookie
/ka/docs/ლექსიკონი/Copyleft	/ka/docs/Glossary/Copyleft
/ka/docs/ლექსიკონი/Crawler	/ka/docs/Glossary/Crawler
/ka/docs/ლექსიკონი/DNS	/ka/docs/Glossary/DNS
/ka/docs/ლექსიკონი/DOM	/ka/docs/Glossary/DOM
/ka/docs/ლექსიკონი/DOS_attack	/ka/docs/Glossary/DOS_attack
/ka/docs/ლექსიკონი/Doctype	/ka/docs/Glossary/Doctype
/ka/docs/ლექსიკონი/Domain_name	/ka/docs/Glossary/Domain_name
/ka/docs/ლექსიკონი/Dynamic_programming_language	/ka/docs/Glossary/Dynamic_programming_language
/ka/docs/ლექსიკონი/ECMA	/ka/docs/Glossary/ECMA
/ka/docs/ლექსიკონი/ECMAScript	/ka/docs/Glossary/ECMAScript
/ka/docs/ლექსიკონი/Empty_element	/ka/docs/Glossary/Empty_element
/ka/docs/ლექსიკონი/Encapsulation	/ka/docs/Glossary/Encapsulation
/ka/docs/ლექსიკონი/Entity_header	/ka/docs/Glossary/Entity_header
/ka/docs/ლექსიკონი/Expando	/ka/docs/Glossary/Expando
/ka/docs/ლექსიკონი/FPS	/ka/docs/Glossary/FPS
/ka/docs/ლექსიკონი/FTP	/ka/docs/Glossary/FTP
/ka/docs/ლექსიკონი/Falsy	/ka/docs/Glossary/Falsy
/ka/docs/ლექსიკონი/First-class_Function	/ka/docs/Glossary/First-class_Function
/ka/docs/ლექსიკონი/First_CPU_idle	/ka/docs/Glossary/First_CPU_idle
/ka/docs/ლექსიკონი/First_contentful_paint	/ka/docs/Glossary/First_contentful_paint
/ka/docs/ლექსიკონი/First_input_delay	/ka/docs/Glossary/First_input_delay
/ka/docs/ლექსიკონი/First_interactive	/ka/docs/Glossary/First_interactive
/ka/docs/ლექსიკონი/First_paint	/ka/docs/Glossary/First_paint
/ka/docs/ლექსიკონი/Flex_Item	/ka/docs/Glossary/Flex_Item
/ka/docs/ლექსიკონი/Flexbox	/ka/docs/Glossary/Flexbox
/ka/docs/ლექსიკონი/Forbidden_header_name	/ka/docs/Glossary/Forbidden_header_name
/ka/docs/ლექსიკონი/Gecko	/ka/docs/Glossary/Gecko
/ka/docs/ლექსიკონი/General_header	/ka/docs/Glossary/General_header
/ka/docs/ლექსიკონი/Git	/ka/docs/Glossary/Git
/ka/docs/ლექსიკონი/Global_object	/ka/docs/Glossary/Global_object
/ka/docs/ლექსიკონი/Grid	/ka/docs/Glossary/Grid
/ka/docs/ლექსიკონი/Grid_Column	/ka/docs/Glossary/Grid_Column
/ka/docs/ლექსიკონი/HTML	/ka/docs/Glossary/HTML
/ka/docs/ლექსიკონი/HTML5	/ka/docs/Glossary/HTML5
/ka/docs/ლექსიკონი/HTTP	/ka/docs/Glossary/HTTP
/ka/docs/ლექსიკონი/HTTP_2	/ka/docs/Glossary/HTTP_2
/ka/docs/ლექსიკონი/Host	/ka/docs/Glossary/Host
/ka/docs/ლექსიკონი/IANA	/ka/docs/Glossary/IANA
/ka/docs/ლექსიკონი/ICANN	/ka/docs/Glossary/ICANN
/ka/docs/ლექსიკონი/IETF	/ka/docs/Glossary/IETF
/ka/docs/ლექსიკონი/IIFE	/ka/docs/Glossary/IIFE
/ka/docs/ლექსიკონი/IP_Address	/ka/docs/Glossary/IP_Address
/ka/docs/ლექსიკონი/ISO	/ka/docs/Glossary/ISO
/ka/docs/ლექსიკონი/Idempotent	/ka/docs/Glossary/Idempotent
/ka/docs/ლექსიკონი/Identifier	/ka/docs/Glossary/Identifier
/ka/docs/ლექსიკონი/IndexedDB	/ka/docs/Glossary/IndexedDB
/ka/docs/ლექსიკონი/Information_architecture	/ka/docs/Glossary/Information_architecture
/ka/docs/ლექსიკონი/Internet	/ka/docs/Glossary/Internet
/ka/docs/ლექსიკონი/JSON	/ka/docs/Glossary/JSON
/ka/docs/ლექსიკონი/Java	/ka/docs/Glossary/Java
/ka/docs/ლექსიკონი/JavaScript	/ka/docs/Glossary/JavaScript
/ka/docs/ლექსიკონი/MIME_type	/ka/docs/Glossary/MIME_type
/ka/docs/ლექსიკონი/Main_Axis	/ka/docs/Glossary/Main_Axis
/ka/docs/ლექსიკონი/MathML	/ka/docs/Glossary/MathML
/ka/docs/ლექსიკონი/Method	/ka/docs/Glossary/Method
/ka/docs/ლექსიკონი/Microsoft_Internet_Explorer	/ka/docs/Glossary/Microsoft_Internet_Explorer
/ka/docs/ლექსიკონი/Mixin	/ka/docs/Glossary/Mixin
/ka/docs/ლექსიკონი/Node.js	/ka/docs/Glossary/Node.js
/ka/docs/ლექსიკონი/Null	/ka/docs/Glossary/Null
/ka/docs/ლექსიკონი/Number	/ka/docs/Glossary/Number
/ka/docs/ლექსიკონი/OOP	/ka/docs/Glossary/OOP
/ka/docs/ლექსიკონი/Object	/ka/docs/Glossary/Object
/ka/docs/ლექსიკონი/OpenGL	/ka/docs/Glossary/OpenGL
/ka/docs/ლექსიკონი/PHP	/ka/docs/Glossary/PHP
/ka/docs/ლექსიკონი/Pixel	/ka/docs/Glossary/Pixel
/ka/docs/ლექსიკონი/Polymorphism	/ka/docs/Glossary/Polymorphism
/ka/docs/ლექსიკონი/Primitive	/ka/docs/Glossary/Primitive
/ka/docs/ლექსიკონი/Progressive_web_apps	/ka/docs/Glossary/Progressive_web_apps
/ka/docs/ლექსიკონი/Promise	/ka/docs/Glossary/Promise
/ka/docs/ლექსიკონი/Prototype-based_programming	/ka/docs/Glossary/Prototype-based_programming
/ka/docs/ლექსიკონი/Pseudo-element	/ka/docs/Glossary/Pseudo-element
/ka/docs/ლექსიკონი/Pseudocode	/ka/docs/Glossary/Pseudocode
/ka/docs/ლექსიკონი/Reflow	/ka/docs/Glossary/Reflow
/ka/docs/ლექსიკონი/Regular_expression	/ka/docs/Glossary/Regular_expression
/ka/docs/ლექსიკონი/Request_header	/ka/docs/Glossary/Request_header
/ka/docs/ლექსიკონი/Responsive_web_design	/ka/docs/Glossary/Responsive_web_design
/ka/docs/ლექსიკონი/Round_Trip_Time_(RTT)	/ka/docs/Glossary/Round_Trip_Time_(RTT)
/ka/docs/ლექსიკონი/SDP	/ka/docs/Glossary/SDP
/ka/docs/ლექსიკონი/SEO	/ka/docs/Glossary/SEO
/ka/docs/ლექსიკონი/SGML	/ka/docs/Glossary/SGML
/ka/docs/ლექსიკონი/SVG	/ka/docs/Glossary/SVG
/ka/docs/ლექსიკონი/Scroll_container	/ka/docs/Glossary/Scroll_container
/ka/docs/ლექსიკონი/Self-Executing_Anonymous_Function	/ka/docs/Glossary/Self-Executing_Anonymous_Function
/ka/docs/ლექსიკონი/Semantics	/ka/docs/Glossary/Semantics
/ka/docs/ლექსიკონი/Server	/ka/docs/Glossary/Server
/ka/docs/ლექსიკონი/Simple_response_header	/ka/docs/Glossary/Simple_response_header
/ka/docs/ლექსიკონი/Sloppy_mode	/ka/docs/Glossary/Sloppy_mode
/ka/docs/ლექსიკონი/Specification	/ka/docs/Glossary/Specification
/ka/docs/ლექსიკონი/Symbol	/ka/docs/conflicting/Web/JavaScript/Reference/Global_Objects/Symbol
/ka/docs/ლექსიკონი/TCP	/ka/docs/Glossary/TCP
/ka/docs/ლექსიკონი/TLS	/ka/docs/Glossary/TLS
/ka/docs/ლექსიკონი/Time_to_interactive	/ka/docs/Glossary/Time_to_interactive
/ka/docs/ლექსიკონი/Tkathy	/ka/docs/Glossary/Tkathy
/ka/docs/ლექსიკონი/Type	/ka/docs/Glossary/Type
/ka/docs/ლექსიკონი/Type_Conversion	/ka/docs/Glossary/Type_Conversion
/ka/docs/ლექსიკონი/Type_coercion	/ka/docs/Glossary/Type_coercion
/ka/docs/ლექსიკონი/UI	/ka/docs/Glossary/UI
/ka/docs/ლექსიკონი/URL	/ka/docs/Glossary/URL
/ka/docs/ლექსიკონი/User_agent	/ka/docs/Glossary/User_agent
/ka/docs/ლექსიკონი/Variable	/ka/docs/Glossary/Variable
/ka/docs/ლექსიკონი/Vendor_Prefix	/ka/docs/Glossary/Vendor_Prefix
/ka/docs/ლექსიკონი/Viewport	/ka/docs/Glossary/Viewport
/ka/docs/ლექსიკონი/W3C	/ka/docs/Glossary/W3C
/ka/docs/ლექსიკონი/WAI	/ka/docs/Glossary/WAI
/ka/docs/ლექსიკონი/WHATWG	/ka/docs/Glossary/WHATWG
/ka/docs/ლექსიკონი/WebKit	/ka/docs/Glossary/WebKit
/ka/docs/ლექსიკონი/WebSockets	/ka/docs/Glossary/WebSockets
/ka/docs/ლექსიკონი/World_Wide_Web	/ka/docs/Glossary/World_Wide_Web
/ka/docs/ლექსიკონი/Wrapper	/ka/docs/Glossary/Wrapper
/ka/docs/ლექსიკონი/XHR_(XMLHttpRequest)	/ka/docs/Glossary/XHR_(XMLHttpRequest)
/ka/docs/ლექსიკონი/XHTML	/ka/docs/Glossary/XHTML
/ka/docs/ლექსიკონი/XML	/ka/docs/Glossary/XML
/ka/docs/ლექსიკონი/application_context	/ka/docs/Glossary/application_context
/ka/docs/ლექსიკონი/baseline	/ka/docs/Glossary/baseline
/ka/docs/ლექსიკონი/cacheable	/ka/docs/Glossary/cacheable
/ka/docs/ლექსიკონი/character_encoding	/ka/docs/Glossary/character_encoding
/ka/docs/ლექსიკონი/data_stkacture	/ka/docs/Glossary/Data_stkacture
/ka/docs/ლექსიკონი/event	/ka/docs/Glossary/event
/ka/docs/ლექსიკონი/first_meaningful_paint	/ka/docs/Glossary/first_meaningful_paint
/ka/docs/ლექსიკონი/global_variable	/ka/docs/Glossary/Global_variable
/ka/docs/ლექსიკონი/https	/ka/docs/Glossary/https
/ka/docs/ლექსიკონი/jQuery	/ka/docs/Glossary/jQuery
/ka/docs/ლექსიკონი/jpeg	/ka/docs/Glossary/jpeg
/ka/docs/ლექსიკონი/loop	/ka/docs/Glossary/loop
/ka/docs/ლექსიკონი/origin	/ka/docs/Glossary/Origin
/ka/docs/ლექსიკონი/privileged_code	/ka/docs/Glossary/privileged_code
/ka/docs/ლექსიკონი/property	/ka/docs/Glossary/property
/ka/docs/ლექსიკონი/safe	/ka/docs/Glossary/safe
/ka/docs/ლექსიკონი/time_to_first_byte	/ka/docs/Glossary/time_to_first_byte
/ka/docs/ლექსიკონი/undefined	/ka/docs/Glossary/undefined
/ka/docs/ლექსიკონი/Аргумент	/ka/docs/Glossary/Argument
/ka/docs/ლექსიკონი/Атрибут	/ka/docs/Glossary/Attribute
/ka/docs/ლექსიკონი/Буфер	/ka/docs/Glossary/buffer
/ka/docs/ლექსიკონი/Выражение	/ka/docs/Glossary/Statement
/ka/docs/ლექსიკონი/Высокоуровневый_язык_программированияprogramming_language	/ka/docs/Glossary/High-level_programming_language
/ka/docs/ლექსიკონი/Гипертекст	/ka/docs/Glossary/Hypertext
/ka/docs/ლექსიკონი/Дешифрование	/ka/docs/Glossary/Decryption
/ka/docs/ლექსიკონი/Домен	/ka/docs/Glossary/Domain
/ka/docs/ლექსიკონი/Доступность	/ka/docs/Glossary/Accessibility
/ka/docs/ლექსიკონი/Заголовок	/ka/docs/Glossary/Head
/ka/docs/ლექსიკონი/Запрещённое_имя_заголовка_ответа	/ka/docs/Glossary/Forbidden_response_header_name
/ka/docs/ლექსიკონი/Инструменты_разработчика	/ka/docs/Glossary/Developer_Tools
/ka/docs/ლექსიკონი/Интернет-провайдер	/ka/docs/Glossary/ISP
/ka/docs/ლექსიკონი/КЦД	/ka/docs/Glossary/CIA
/ka/docs/ლექსიკონი/Константа	/ka/docs/Glossary/Constant
/ka/docs/ლექსიკონი/Кэш	/ka/docs/Glossary/Cache
/ka/docs/ლექსიკონი/Массив	/ka/docs/Glossary/array
/ka/docs/ლექსიკონი/Метаданные	/ka/docs/Glossary/Metadata
/ka/docs/ლექსიკონი/Поднятие	/ka/docs/Glossary/Hoisting
/ka/docs/ლექსიკონი/Порт	/ka/docs/Glossary/Port
/ka/docs/ლექსიკონი/Пробельные_символы	/ka/docs/Glossary/Whitespace
/ka/docs/ლექსიკონი/Прокси_сервер	/ka/docs/Glossary/Proxy_server
/ka/docs/ლექსიკონი/Простой_заголовок	/ka/docs/Glossary/Simple_header
/ka/docs/ლექსიკონი/პროტოკოლი	/ka/docs/Glossary/Protocol
/ka/docs/ლექსიკონი/პროტოტიპი	/ka/docs/Glossary/Prototype
/ka/docs/ლექსიკონი/სერთიფიცირებული	/ka/docs/Glossary/Certified
/ka/docs/ლექსიკონი/სინქრონული	/ka/docs/Glossary/Synchronous
/ka/docs/ლექსიკონი/სტატიკური_ტიპიზაცია	/ka/docs/Glossary/Static_typing
/ka/docs/ლექსიკონი/სტრიქონი	/ka/docs/Glossary/String
/ka/docs/ლექსიკონი/სუბიექტი	/ka/docs/Glossary/Entity
/ka/docs/ლექსიკონი/ტეგი	/ka/docs/Glossary/Tag
/ka/docs/ლექსიკონი/ფუნქცია	/ka/docs/Glossary/Function
/ka/docs/ლექსიკონი/ელემენტი	/ka/docs/Glossary/Element
/ka/docs/ლექსიკონი/ცარიელი_ელემენტი	/ka/docs/Glossary/Empty_element
/ka/docs/ლექსიკონი/უკუ_გამოძახების_ფუნქცია	/ka/docs/Glossary/Callback_function
/ka/docs/ლექსიკონი/ქეში	/ka/docs/Glossary/hash
/ka/docs/ცნობარი_JavaScript_1.5	/ka/docs/Web/JavaScript/Reference
/ka/docs/ცნობარი_JavaScript_1.5/გლობალური_ობიექტები	/ka/docs/Web/JavaScript/Reference/Global_Objects
/ka/docs/ცნობარი_JavaScript_1.5/გლობალური_ობიექტები/Array	/ka/docs/Web/JavaScript/Reference/Global_Objects/Array
/ka/docs/ცნობარი_JavaScript_1.5/გლობალური_ობიექტები/Array/Array	/ka/docs/Web/JavaScript/Reference/Global_Objects/Array
/ka/docs/ცნობარი_JavaScript_1.5/გლობალური_ობიექტები/Array/MDC	/ka/docs/Web/JavaScript/Reference/Global_Objects/Array
/ka/docs/ცნობარი_JavaScript_1.5/გლობალური_ობიექტები/Array/map	/ka/docs/Web/JavaScript/Reference/Global_Objects/Array/map
/ka/docs/ცნობარი_JavaScript_1.5/გლობალური_ობიექტები/Boolean	/ka/docs/Web/JavaScript/Reference/Global_Objects/Boolean
/ka/docs/ცნობარი_JavaScript_1.5/გლობალური_ობიექტები/Function	/ka/docs/Web/JavaScript/Reference/Global_Objects/Function
/ka/docs/ცნობარი_JavaScript_1.5/გლობალური_ობიექტები/Function/length	/ka/docs/Web/JavaScript/Reference/Global_Objects/Function/length
/ka/docs/ცნობარი_JavaScript_1.5/გლობალური_ობიექტები/Math	/ka/docs/Web/JavaScript/Reference/Global_Objects/Math
/ka/docs/ცნობარი_JavaScript_1.5/გლობალური_ობიექტები/Object	/ka/docs/Web/JavaScript/Reference/Global_Objects/Object
/ka/docs/ცნობარი_JavaScript_1.5/გლობალური_ობიექტები/RegExp	/ka/docs/Web/JavaScript/Reference/Global_Objects/RegExp
/ka/docs/ცნობარი_JavaScript_1.5/გლობალური_ფუნქციები	/ka/docs/Web/JavaScript/Reference/Global_Objects
/ka/docs/ცნობარი_JavaScript_1.5/გლობალური_ფუნქციები/String	/ka/docs/Web/JavaScript/Reference/Global_Objects/String
/ka/docs/ცნობარი_JavaScript_1.5/გლობალური_ფუნქციები/isNaN	/ka/docs/Web/JavaScript/Reference/Global_Objects/isNaN
/ka/docs/ცნობარი_JavaScript_1.5/ოპერატორები	/ka/docs/Web/JavaScript/Reference/Operators
/ka/docs/ცნობარი_JavaScript_1.5/ოპერაციები	/ka/docs/Web/JavaScript/Reference/Operators
/ka/docs/ცნობარი_JavaScript_1.5/ოპერაციები/Assignment_Operators	/ka/docs/Web/JavaScript/Reference/Operators
/ka/docs/ცნობარი_JavaScript_1.5:გლობალური_ობიექტები	/ka/docs/Web/JavaScript/Reference/Global_Objects
/ka/docs/ცნობარი_JavaScript_1.5:გლობალური_ფუნქციები:String	/ka/docs/Web/JavaScript/Reference/Global_Objects/String
/ka/docs/ცნობარი_JavaScript_1.5:გლობალური_ფუნქციები:isNaN	/ka/docs/Web/JavaScript/Reference/Global_Objects/isNaN
/ka/docs/ბირთვი_JavaScript_1.5_ცნობარი	/ka/docs/Web/JavaScript/Reference
/ka/docs/ბირთვი_JavaScript_1.5_ცნობარი/Functions	/ka/docs/Web/JavaScript/Reference/Functions
/ka/docs/ბირთვი_JavaScript_1.5_ცნობარი/Functions/Arrow_functions	/ka/docs/Web/JavaScript/Reference/Functions/Arrow_functions
/ka/docs/ბირთვი_JavaScript_1.5_ცნობარი/Functions/rest_parameters	/ka/docs/Web/JavaScript/Reference/Functions/Rest_parameters
/ka/docs/ბირთვი_JavaScript_1.5_ცნობარი:Functions	/ka/docs/Web/JavaScript/Reference/Functions
